chrom	juncStart	juncEnd	anchorStart	anchorEnd	name	score	strand	5o	3o	5o_score	3o_score	max_o_score
chrX	252251	266338	252226	266389	JUNC00000001	1	+	25	51	-304.0	-304.0	-304.0
chrX	257645	299771	257623	299841	JUNC00000002	2	-	22	70	-304.0	-304.0	-304.0
chrX	269324	269434	269294	269480	JUNC00000003	1	-	30	46	144.0	144.0	144.0
chrX	269324	269654	269294	269700	JUNC00000005	1	-	30	46	144.0	132.0	144.0
chrX	269324	269819	269294	269865	JUNC00000004	1	-	30	46	144.0	140.0	144.0
chrX	276394	281481	276360	281550	JUNC00000006	5	+	34	69	-304.0	-304.0	-304.0
chrX	277519	277936	277468	277961	JUNC00000007	1	+	51	25	-304.0	-304.0	-304.0
chrX	277668	277936	277617	277961	JUNC00000008	1	+	51	25	-304.0	-304.0	-304.0
chrX	277885	277936	277834	277961	JUNC00000009	1	+	51	25	-304.0	-304.0	-304.0
chrX	281256	281609	281238	281684	JUNC00000010	2	+	18	75	-304.0	-304.0	-304.0
chrX	281684	283092	281609	283120	JUNC00000012	2	+	75	28	-304.0	-304.0	-304.0
chrX	281684	284166	281609	284241	JUNC00000011	172	+	75	75	-304.0	-304.0	-304.0
chrX	284314	288732	284243	288807	JUNC00000013	222	+	71	75	-304.0	-304.0	-304.0
chrX	288869	290647	288794	290721	JUNC00000014	202	+	75	74	-304.0	-304.0	-304.0
chrX	290196	385849	290151	385880	JUNC00000015	1	+	45	31	-304.0	-304.0	-304.0
chrX	290776	291498	290701	291573	JUNC00000016	137	+	75	75	-304.0	-304.0	-304.0
chrX	291654	293034	291580	293108	JUNC00000017	144	+	74	74	-304.0	-304.0	-304.0
chrX	292388	299982	292335	300005	JUNC00000018	1	+	53	23	-304.0	-304.0	-304.0
chrX	293218	299096	293144	299171	JUNC00000019	121	+	74	75	-304.0	-304.0	-304.0
chrX	295606	302475	295577	302519	JUNC00000020	1	-	29	44	-304.0	-304.0	-304.0
chrX	299982	303713	299949	303784	JUNC00000021	3	+	33	71	-304.0	-304.0	-304.0
chrX	305197	307359	305122	307430	JUNC00000022	215	-	75	71	-304.0	-304.0	-304.0
chrX	305237	307252	305202	307293	JUNC00000023	1	+	35	41	-304.0	-304.0	-304.0
chrX	305237	312554	305220	312613	JUNC00000024	1	+	17	59	-304.0	-304.0	-304.0
chrX	306342	306706	306292	306732	JUNC00000025	1	-	50	26	142.0	152.0	152.0
chrX	307506	307731	307477	307794	JUNC00000027	2	-	29	63	-304.0	-304.0	-304.0
chrX	307512	307731	307439	307806	JUNC00000026	69	-	73	75	-304.0	-304.0	-304.0
chrX	307880	311418	307806	311493	JUNC00000028	68	-	74	75	-304.0	-304.0	-304.0
chrX	311622	312765	311547	312814	JUNC00000029	2	-	75	49	-304.0	-304.0	-304.0
chrX	311627	312531	311598	312578	JUNC00000032	1	-	29	47	-304.0	-304.0	-304.0
chrX	311627	312717	311579	312745	JUNC00000031	1	-	48	28	-304.0	-304.0	-304.0
chrX	311627	312765	311559	312840	JUNC00000030	64	-	68	75	-304.0	-304.0	-304.0
chrX	312924	314149	312849	314218	JUNC00000033	168	-	75	69	-304.0	-304.0	-304.0
chrX	314217	314889	314148	314964	JUNC00000034	184	-	69	75	-304.0	-304.0	-304.0
chrX	315020	315228	314945	315301	JUNC00000035	149	-	75	73	-304.0	-304.0	-304.0
chrX	315299	315371	315282	315430	JUNC00000038	1	-	17	59	-304.0	-304.0	-304.0
chrX	315299	316779	315262	316815	JUNC00000037	1	-	37	36	-304.0	-304.0	-304.0
chrX	315299	316913	315228	316988	JUNC00000036	136	-	71	75	-304.0	-304.0	-304.0
chrX	315553	315689	315530	315742	JUNC00000039	2	?	23	53	80.0	96.0	96.0
chrX	315622	315748	315554	315799	JUNC00000040	11	?	68	51	120.0	122.0	122.0
chrX	315683	315760	315628	315779	JUNC00000041	1	+	55	19	-304.0	-304.0	-304.0
chrX	316047	316171	315983	316213	JUNC00000042	4	?	64	42	138.0	144.0	144.0
chrX	317051	317278	317021	317319	JUNC00000044	1	-	30	41	-304.0	-304.0	-304.0
chrX	317051	318438	316976	318513	JUNC00000043	28	-	75	75	-304.0	-304.0	-304.0
chrX	317484	318438	317431	318513	JUNC00000045	4	-	53	75	-304.0	-304.0	-304.0
chrX	323579	323725	323535	323757	JUNC00000046	1	+	44	32	124.0	124.0	124.0
chrX	323661	323904	323595	323939	JUNC00000047	3	+	66	35	138.0	140.0	140.0
chrX	323793	323904	323727	323939	JUNC00000048	4	+	66	35	138.0	134.0	138.0
chrX	325349	365313	325321	365361	JUNC00000049	1	+	28	48	-304.0	-304.0	-304.0
chrX	334517	338603	334465	338661	JUNC00000050	3	-	52	58	-304.0	-304.0	-304.0
chrX	335696	338603	335661	338644	JUNC00000051	1	-	35	41	-304.0	-304.0	-304.0
chrX	340940	341306	340867	341373	JUNC00000052	15	-	73	67	-304.0	-304.0	-304.0
chrX	341396	341882	341322	341931	JUNC00000053	35	-	74	49	-304.0	-304.0	-304.0
chrX	341931	345515	341857	345590	JUNC00000054	51	-	74	75	-304.0	-304.0	-304.0
chrX	343115	343791	343064	343816	JUNC00000055	1	-	51	25	-304.0	-304.0	-304.0
chrX	345672	346173	345597	346246	JUNC00000056	55	-	75	73	-304.0	-304.0	-304.0
chrX	346260	346700	346186	346769	JUNC00000057	45	-	74	69	-304.0	-304.0	-304.0
chrX	346775	347233	346701	347307	JUNC00000058	34	-	74	74	-304.0	-304.0	-304.0
chrX	347336	347589	347262	347657	JUNC00000059	20	-	74	68	-304.0	-304.0	-304.0
chrX	347693	361404	347624	361474	JUNC00000060	12	-	69	70	-304.0	-304.0	-304.0
chrX	361590	386367	361527	386432	JUNC00000061	18	-	63	65	-304.0	-304.0	-304.0
chrX	387290	405406	387232	405460	JUNC00000062	3	+	58	54	-304.0	-304.0	-304.0
chrX	387290	416124	387271	416181	JUNC00000063	1	+	19	57	-304.0	-304.0	-304.0
chrX	430489	433836	430438	433861	JUNC00000064	1	+	51	25	-304.0	-304.0	-304.0
chrX	438573	490887	438528	490918	JUNC00000065	1	-	45	31	-304.0	-304.0	-304.0
chrX	583636	616414	583620	616474	JUNC00000066	1	-	16	60	-304.0	-304.0	-304.0
chrX	639923	670104	639894	670147	JUNC00000067	1	-	29	43	-304.0	-304.0	-304.0
chrX	664884	671678	664862	671732	JUNC00000068	1	-	22	54	-304.0	-304.0	-304.0
chrX	688565	740611	688535	740652	JUNC00000069	1	-	30	41	-304.0	-304.0	-304.0
chrX	911757	934243	911715	934271	JUNC00000070	1	+	42	28	120.0	114.0	120.0
chrX	1032978	1036323	1032936	1036355	JUNC00000071	1	+	42	32	-304.0	-304.0	-304.0
chrX	1046788	1105299	1046755	1105337	JUNC00000072	1	-	33	38	-304.0	-304.0	-304.0
chrX	1177217	1209870	1177193	1209922	JUNC00000073	1	+	24	52	-304.0	-304.0	-304.0
chrX	1191160	1193217	1191147	1193280	JUNC00000074	1	-	13	63	-304.0	-304.0	-304.0
chrX	1193302	1196779	1193256	1196824	JUNC00000075	2	-	46	45	-304.0	-304.0	-304.0
chrX	1224464	1275320	1224435	1275366	JUNC00000076	1	+	29	46	-304.0	-304.0	-304.0
chrX	1224760	1275320	1224731	1275366	JUNC00000077	1	+	29	46	-304.0	-304.0	-304.0
chrX	1231591	1246144	1231544	1246173	JUNC00000078	1	+	47	29	-304.0	-304.0	-304.0
chrX	1242501	1275313	1242475	1275363	JUNC00000079	1	-	26	50	-304.0	-304.0	-304.0
chrX	1256990	1283710	1256954	1283750	JUNC00000080	1	+	36	40	-304.0	-304.0	-304.0
chrX	1285920	1288518	1285864	1288584	JUNC00000081	2	+	56	66	-304.0	-304.0	-304.0
chrX	1305527	1309401	1305515	1309465	JUNC00000082	1	+	12	64	-304.0	-304.0	-304.0
chrX	1306462	1331997	1306442	1332052	JUNC00000083	1	-	20	55	-304.0	-304.0	-304.0
chrX	1336926	1341727	1336851	1341802	JUNC00000084	65	+	75	75	-304.0	-304.0	-304.0
chrX	1336926	1341730	1336854	1341804	JUNC00000085	7	+	72	74	-304.0	-304.0	-304.0
chrX	1341813	1352309	1341747	1352356	JUNC00000086	3	-	66	47	-304.0	-304.0	-304.0
chrX	1341829	1345315	1341754	1345390	JUNC00000087	76	+	75	75	-304.0	-304.0	-304.0
chrX	1345434	1348430	1345359	1348505	JUNC00000089	61	+	75	75	-304.0	-304.0	-304.0
chrX	1345434	1348434	1345414	1348490	JUNC00000090	1	+	20	56	-304.0	-304.0	-304.0
chrX	1345434	1352099	1345359	1352125	JUNC00000088	2	+	75	26	-304.0	-304.0	-304.0
chrX	1346374	1385179	1346356	1385236	JUNC00000091	1	+	18	57	-304.0	108.0	108.0
chrX	1348545	1352099	1348479	1352174	JUNC00000092	53	+	66	75	-304.0	-304.0	-304.0
chrX	1350586	1352309	1350547	1352346	JUNC00000093	1	-	39	37	-304.0	-304.0	-304.0
chrX	1352232	1352321	1352158	1352382	JUNC00000095	33	+	74	61	-304.0	-304.0	-304.0
chrX	1352232	1352324	1352158	1352399	JUNC00000094	20	+	74	75	-304.0	-304.0	-304.0
chrX	1352471	1352551	1352396	1352568	JUNC00000096	2	-	75	17	-304.0	-304.0	-304.0
chrX	1352471	1352554	1352421	1352580	JUNC00000098	1	-	50	26	-304.0	-304.0	-304.0
chrX	1352471	1352619	1352413	1352672	JUNC00000097	4	-	58	53	-304.0	-304.0	-304.0
chrX	1352506	1356220	1352432	1356291	JUNC00000099	63	+	74	71	-304.0	-304.0	-304.0
chrX	1352718	1355571	1352662	1355621	JUNC00000100	4	-	56	50	-304.0	-304.0	-304.0
chrX	1354346	1356220	1354325	1356275	JUNC00000101	1	+	21	55	-304.0	-304.0	-304.0
chrX	1356140	1365102	1356102	1365137	JUNC00000103	1	-	38	35	-304.0	-304.0	-304.0
chrX	1356140	1367955	1356091	1367982	JUNC00000102	1	-	49	27	-304.0	-304.0	-304.0
chrX	1356336	1358860	1356265	1358889	JUNC00000104	75	+	71	29	-304.0	-304.0	-304.0
chrX	1356336	1365137	1356319	1365207	JUNC00000107	3	+	17	70	-304.0	-304.0	-304.0
chrX	1358428	1368028	1358401	1368077	JUNC00000108	1	+	27	49	-304.0	-304.0	-304.0
chrX	1358887	1363744	1358860	1363764	JUNC00000106	1	+	27	20	-304.0	-304.0	-304.0
chrX	1358887	1365137	1358858	1365212	JUNC00000105	75	+	29	75	-304.0	-304.0	-304.0
chrX	1360041	1360133	1359989	1360157	JUNC00000109	1	?	52	24	-304.0	-304.0	-304.0
chrX	1361506	1361604	1361487	1361661	JUNC00000110	1	-	19	57	-304.0	-304.0	-304.0
chrX	1365171	1367951	1365125	1367981	JUNC00000112	1	-	46	30	-304.0	-304.0	-304.0
chrX	1365171	1367955	1365117	1367996	JUNC00000111	3	-	54	41	-304.0	-304.0	-304.0
chrX	1365252	1378658	1365178	1378729	JUNC00000113	44	+	74	71	-304.0	-304.0	-304.0
chrX	1368090	1378321	1368047	1378354	JUNC00000114	1	-	43	33	-304.0	-304.0	-304.0
chrX	1378476	1378692	1378426	1378731	JUNC00000115	2	-	50	39	-304.0	-304.0	-304.0
chrX	1378764	1381022	1378693	1381095	JUNC00000116	64	+	71	73	-304.0	-304.0	-304.0
chrX	1378812	1386681	1378783	1386756	JUNC00000117	8	-	29	75	-304.0	-304.0	-304.0
chrX	1381104	1382390	1381029	1382464	JUNC00000118	80	+	75	74	-304.0	-304.0	-304.0
chrX	1382865	1382965	1382835	1383011	JUNC00000119	1	-	30	46	-304.0	-304.0	-304.0
chrX	1386278	1386551	1386241	1386625	JUNC00000120	5	?	37	74	-304.0	-304.0	-304.0
chrX	1386447	1386541	1386374	1386581	JUNC00000121	6	?	73	40	-304.0	-304.0	-304.0
chrX	1386759	1387278	1386684	1387353	JUNC00000122	1807	-	75	75	-304.0	-304.0	-304.0
chrX	1387419	1389240	1387344	1389315	JUNC00000123	3415	-	75	75	-304.0	-304.0	-304.0
chrX	1389727	1390082	1389652	1390123	JUNC00000125	4	-	75	41	-304.0	-304.0	-304.0
chrX	1389727	1390191	1389667	1390260	JUNC00000126	12	-	60	69	-304.0	-304.0	-304.0
chrX	1389727	1391898	1389652	1391973	JUNC00000124	1674	-	75	75	-304.0	-304.0	-304.0
chrX	1390290	1391898	1390223	1391973	JUNC00000127	11	-	67	75	-304.0	-304.0	-304.0
chrX	1390293	1391898	1390262	1391945	JUNC00000128	2	-	31	47	-304.0	-304.0	-304.0
chrX	1394896	1396371	1394861	1396412	JUNC00000129	1	+	35	41	-304.0	-304.0	-304.0
chrX	1396648	1396997	1396599	1397055	JUNC00000130	2	+	49	58	-304.0	-304.0	-304.0
chrX	1397224	1398824	1397194	1398890	JUNC00000131	2	+	30	66	-304.0	-304.0	-304.0
chrX	1397699	1398824	1397680	1398896	JUNC00000132	2	+	19	72	-304.0	-304.0	-304.0
chrX	1398958	1399366	1398896	1399380	JUNC00000133	1	+	62	14	-304.0	-304.0	-304.0
chrX	1398958	1400160	1398898	1400211	JUNC00000134	2	+	60	51	-304.0	-304.0	-304.0
chrX	1400238	1401497	1400186	1401569	JUNC00000135	2	+	52	72	-304.0	-304.0	-304.0
chrX	1401054	1401089	1400994	1401105	JUNC00000136	1	-	60	16	-304.0	-304.0	-304.0
chrX	1402225	1403162	1402170	1403237	JUNC00000138	3	+	55	75	-304.0	-304.0	-304.0
chrX	1402225	1403460	1402154	1403533	JUNC00000137	9	+	71	73	-304.0	-304.0	-304.0
chrX	1403489	1412731	1403417	1412806	JUNC00000139	128	-	72	75	-304.0	-304.0	-304.0
chrX	1403489	1417972	1403434	1417993	JUNC00000140	2	-	55	21	-304.0	-304.0	-304.0
chrX	1403585	1411356	1403563	1411410	JUNC00000142	1	+	22	54	-304.0	-304.0	-304.0
chrX	1403585	1412742	1403520	1412817	JUNC00000141	16	+	65	75	-304.0	-304.0	-304.0
chrX	1404843	1405613	1404786	1405632	JUNC00000143	1	+	57	19	-304.0	-304.0	-304.0
chrX	1408340	1409495	1408303	1409534	JUNC00000144	1	+	37	39	148.0	148.0	148.0
chrX	1408550	1409495	1408513	1409534	JUNC00000145	1	+	37	39	148.0	148.0	148.0
chrX	1408655	1409495	1408618	1409534	JUNC00000146	1	+	37	39	148.0	148.0	148.0
chrX	1408865	1409495	1408828	1409534	JUNC00000147	1	+	37	39	148.0	148.0	148.0
chrX	1412854	1417972	1412779	1418046	JUNC00000148	180	-	75	74	-304.0	-304.0	-304.0
chrX	1412854	1421657	1412828	1421732	JUNC00000149	5	-	26	75	-304.0	-304.0	-304.0
chrX	1412888	1413748	1412839	1413821	JUNC00000150	2	+	49	73	-304.0	-304.0	-304.0
chrX	1412888	1413761	1412854	1413832	JUNC00000152	4	+	34	71	-304.0	-304.0	-304.0
chrX	1412888	1414082	1412839	1414109	JUNC00000151	1	+	49	27	-304.0	-304.0	-304.0
chrX	1414310	1414742	1414286	1414794	JUNC00000154	2	+	24	52	-304.0	-304.0	-304.0
chrX	1414310	1421419	1414266	1421451	JUNC00000153	1	+	44	32	-304.0	-304.0	-304.0
chrX	1418116	1418981	1418041	1419055	JUNC00000155	112	-	75	74	-304.0	-304.0	-304.0
chrX	1419114	1421657	1419039	1421732	JUNC00000156	138	-	75	75	-304.0	-304.0	-304.0
chrX	1419131	1421657	1419090	1421692	JUNC00000157	1	-	41	35	-304.0	-304.0	-304.0
chrX	1421842	1425524	1421767	1425599	JUNC00000158	223	-	75	75	-304.0	-304.0	-304.0
chrX	1423597	1423617	1423573	1423669	JUNC00000159	1	?	24	52	112.0	112.0	112.0
chrX	1425687	1427733	1425612	1427808	JUNC00000160	108	-	75	75	-304.0	-304.0	-304.0
chrX	1428121	1432268	1428047	1432343	JUNC00000161	180	-	74	75	-304.0	-304.0	-304.0
chrX	1428267	1432268	1428208	1432297	JUNC00000162	2	-	59	29	-304.0	-304.0	-304.0
chrX	1432377	1435021	1432303	1435096	JUNC00000163	240	-	74	75	-304.0	-304.0	-304.0
chrX	1435083	1435693	1435021	1435759	JUNC00000164	242	-	62	66	-304.0	-304.0	-304.0
chrX	1435758	1439096	1435692	1439147	JUNC00000165	113	-	66	51	-304.0	-304.0	-304.0
chrX	1439144	1442119	1439129	1442180	JUNC00000166	1	-	15	61	-304.0	-304.0	-304.0
chrX	1442317	1443009	1442280	1443048	JUNC00000168	1	-	37	39	-304.0	-304.0	-304.0
chrX	1442317	1452747	1442243	1452822	JUNC00000167	88	-	74	75	-304.0	-304.0	-304.0
chrX	1461991	1462110	1461945	1462149	JUNC00000169	2	?	46	39	90.0	104.0	104.0
chrX	1461991	1462110	1461959	1462119	JUNC00000170	1	-	32	9	90.0	104.0	104.0
chrX	1462088	1462215	1462062	1462265	JUNC00000172	1	?	26	50	-304.0	124.0	124.0
chrX	1462119	1462175	1462110	1462210	JUNC00000171	1	-	9	35	116.0	108.0	116.0
chrX	1462199	1462258	1462157	1462306	JUNC00000173	3	?	42	48	80.0	82.0	82.0
chrX	1463463	1666445	1463388	1666480	JUNC00000174	11	+	75	35	-304.0	-304.0	-304.0
chrX	1463484	1666445	1463409	1666474	JUNC00000175	53	+	75	29	-304.0	-304.0	-304.0
chrX	1466582	1468501	1466556	1468568	JUNC00000179	2	-	26	67	-304.0	-304.0	-304.0
chrX	1466582	1481089	1466535	1481118	JUNC00000178	1	-	47	29	-304.0	-304.0	-304.0
chrX	1466582	1492996	1466508	1493059	JUNC00000177	5	-	74	63	-304.0	-304.0	-304.0
chrX	1466582	1494092	1466560	1494159	JUNC00000180	3	-	22	67	-304.0	-304.0	-304.0
chrX	1466582	1536920	1466508	1536994	JUNC00000176	105	-	74	74	-304.0	-304.0	-304.0
chrX	1473691	1474113	1473643	1474141	JUNC00000181	1	+	48	28	-304.0	-304.0	-304.0
chrX	1474406	1474941	1474356	1474967	JUNC00000182	1	+	50	26	140.0	136.0	140.0
chrX	1474643	1474941	1474593	1474967	JUNC00000183	1	+	50	26	148.0	148.0	148.0
chrX	1482109	1536920	1482059	1536994	JUNC00000184	2	-	50	74	-304.0	-304.0	-304.0
chrX	1483250	1492996	1483225	1493047	JUNC00000187	1	-	25	51	-304.0	-304.0	-304.0
chrX	1483250	1494092	1483203	1494121	JUNC00000186	1	-	47	29	-304.0	-304.0	-304.0
chrX	1483250	1536920	1483188	1536994	JUNC00000185	6	-	62	74	-304.0	-304.0	-304.0
chrX	1486153	1504251	1486111	1504283	JUNC00000188	1	+	42	32	-304.0	-304.0	-304.0
chrX	1493121	1494092	1493063	1494137	JUNC00000189	3	-	58	45	-304.0	-304.0	-304.0
chrX	1504638	1532786	1504567	1532807	JUNC00000192	2	+	71	21	-304.0	-304.0	-304.0
chrX	1504638	1537943	1504567	1537964	JUNC00000190	2	+	71	21	-304.0	-304.0	-304.0
chrX	1504638	1562782	1504567	1562803	JUNC00000191	2	+	71	21	-304.0	-304.0	-304.0
chrX	1508591	1509206	1508543	1509233	JUNC00000193	1	-	48	27	-304.0	-304.0	-304.0
chrX	1517955	1518271	1517934	1518326	JUNC00000194	1	?	21	55	-304.0	130.0	130.0
chrX	1591769	1593443	1591742	1593517	JUNC00000195	8	+	27	74	-304.0	-304.0	-304.0
chrX	1594224	1595383	1594149	1595458	JUNC00000196	189	+	75	75	-304.0	-304.0	-304.0
chrX	1595532	1599191	1595457	1599266	JUNC00000197	239	+	75	75	-304.0	-304.0	-304.0
chrX	1596613	1596914	1596568	1596945	JUNC00000198	1	+	45	31	118.0	-304.0	118.0
chrX	1596660	1596914	1596615	1596945	JUNC00000199	1	+	45	31	118.0	-304.0	118.0
chrX	1596707	1596914	1596662	1596945	JUNC00000200	1	+	45	31	118.0	-304.0	118.0
chrX	1599432	1600137	1599360	1600207	JUNC00000202	25	+	72	70	-304.0	-304.0	-304.0
chrX	1599432	1600658	1599357	1600731	JUNC00000201	88	+	75	73	-304.0	-304.0	-304.0
chrX	1600207	1600658	1600137	1600717	JUNC00000203	10	+	70	59	-304.0	-304.0	-304.0
chrX	1615268	1623138	1615247	1623193	JUNC00000204	1	+	21	55	-304.0	-304.0	-304.0
chrX	1620445	1659058	1620422	1659111	JUNC00000205	1	+	23	53	-304.0	-304.0	-304.0
chrX	1623607	1624268	1623550	1624337	JUNC00000206	2	+	57	69	-304.0	-304.0	-304.0
chrX	1624398	1627702	1624325	1627764	JUNC00000207	7	+	73	62	-304.0	-304.0	-304.0
chrX	1627771	1629820	1627709	1629895	JUNC00000208	10	+	62	75	-304.0	-304.0	-304.0
chrX	1629939	1632703	1629918	1632758	JUNC00000211	1	+	21	55	-304.0	-304.0	-304.0
chrX	1629939	1633149	1629910	1633196	JUNC00000210	1	+	29	47	-304.0	-304.0	-304.0
chrX	1629939	1636437	1629879	1636471	JUNC00000209	2	+	60	34	-304.0	-304.0	-304.0
chrX	1633290	1636437	1633233	1636456	JUNC00000212	1	+	57	19	-304.0	-304.0	-304.0
chrX	1636560	1642802	1636511	1642845	JUNC00000213	2	+	49	43	-304.0	-304.0	-304.0
chrX	1657871	1660132	1657799	1660161	JUNC00000214	2	+	72	29	-304.0	-304.0	-304.0
chrX	1657871	1660147	1657799	1660209	JUNC00000215	8	+	72	62	-304.0	-304.0	-304.0
chrX	1657871	1660409	1657840	1660454	JUNC00000217	1	+	31	45	-304.0	-304.0	-304.0
chrX	1657871	1726066	1657832	1726118	JUNC00000216	3	+	39	52	-304.0	-304.0	-304.0
chrX	1662052	1662160	1661981	1662227	JUNC00000218	3	+	71	67	-304.0	-304.0	-304.0
chrX	1662052	1726066	1661984	1726130	JUNC00000219	8	+	68	64	-304.0	-304.0	-304.0
chrX	1662221	1726066	1662187	1726122	JUNC00000220	2	+	34	56	-304.0	-304.0	-304.0
chrX	1677373	1679499	1677327	1679529	JUNC00000222	1	+	46	30	-304.0	-304.0	-304.0
chrX	1677373	1726066	1677305	1726127	JUNC00000221	19	+	68	61	-304.0	-304.0	-304.0
chrX	1693631	1732427	1693605	1732477	JUNC00000223	1	-	26	50	132.0	122.0	132.0
chrX	1696476	1726066	1696451	1726117	JUNC00000224	1	+	25	51	-304.0	-304.0	-304.0
chrX	1696650	1697661	1696606	1697677	JUNC00000225	1	-	44	16	-304.0	-304.0	-304.0
chrX	1696650	1698417	1696606	1698433	JUNC00000227	1	-	44	16	-304.0	-304.0	-304.0
chrX	1697677	1699189	1697661	1699205	JUNC00000226	1	-	16	16	118.0	118.0	118.0
chrX	1698433	1699189	1698417	1699205	JUNC00000228	1	-	16	16	118.0	118.0	118.0
chrX	1726154	1726317	1726115	1726387	JUNC00000231	2	+	39	70	-304.0	-304.0	-304.0
chrX	1726154	1730877	1726080	1730950	JUNC00000229	28	+	74	73	-304.0	-304.0	-304.0
chrX	1726154	1751286	1726101	1751346	JUNC00000230	3	+	53	60	-304.0	-304.0	-304.0
chrX	1726154	1755683	1726134	1755739	JUNC00000232	1	+	20	56	-304.0	-304.0	-304.0
chrX	1728185	1741016	1728170	1741077	JUNC00000234	1	-	15	61	-304.0	-304.0	-304.0
chrX	1730219	1730877	1730161	1730895	JUNC00000235	1	+	58	18	-304.0	-304.0	-304.0
chrX	1732531	1732572	1732492	1732609	JUNC00000236	1	?	39	37	-304.0	-304.0	-304.0
chrX	1732723	1733949	1732655	1734013	JUNC00000237	12	+	68	64	-304.0	-304.0	-304.0
chrX	1732723	1733952	1732669	1734008	JUNC00000238	3	+	54	56	-304.0	-304.0	-304.0
chrX	1734196	1741930	1734129	1742005	JUNC00000239	45	+	67	75	-304.0	-304.0	-304.0
chrX	1734196	1743476	1734163	1743545	JUNC00000242	3	+	33	69	-304.0	-304.0	-304.0
chrX	1734196	1743479	1734147	1743506	JUNC00000241	1	+	49	27	-304.0	-304.0	-304.0
chrX	1734196	1770496	1734143	1770515	JUNC00000240	1	+	53	19	-304.0	-304.0	-304.0
chrX	1734464	1741930	1734420	1741962	JUNC00000243	1	+	44	32	-304.0	-304.0	-304.0
chrX	1739625	1739957	1739580	1739988	JUNC00000244	1	+	45	31	-304.0	-304.0	-304.0
chrX	1742026	1743476	1741951	1743526	JUNC00000245	3	+	75	50	-304.0	-304.0	-304.0
chrX	1742026	1743479	1741966	1743545	JUNC00000248	9	+	60	66	-304.0	-304.0	-304.0
chrX	1742026	1743587	1741951	1743662	JUNC00000246	5	+	75	75	-304.0	-304.0	-304.0
chrX	1742026	1747291	1742002	1747343	JUNC00000249	1	+	24	52	-304.0	-304.0	-304.0
chrX	1742026	1755683	1741957	1755758	JUNC00000247	16	+	69	75	-304.0	-304.0	-304.0
chrX	1743110	1743600	1743077	1743643	JUNC00000250	1	+	33	43	-304.0	-304.0	-304.0
chrX	1743693	1743786	1743618	1743858	JUNC00000251	32	+	75	72	-304.0	-304.0	-304.0
chrX	1744111	1744467	1744057	1744525	JUNC00000252	4	+	54	58	-304.0	-304.0	-304.0
chrX	1744111	1744471	1744088	1744539	JUNC00000253	2	+	23	68	-304.0	-304.0	-304.0
chrX	1744574	1747291	1744511	1747321	JUNC00000255	2	+	63	30	-304.0	-304.0	-304.0
chrX	1744574	1755683	1744507	1755758	JUNC00000254	6	+	67	75	-304.0	-304.0	-304.0
chrX	1745344	1745453	1745288	1745513	JUNC00000256	4	+	56	60	-304.0	-304.0	-304.0
chrX	1747543	1751286	1747501	1751346	JUNC00000257	3	+	42	60	-304.0	-304.0	-304.0
chrX	1751346	1755683	1751284	1755758	JUNC00000233	8	+	62	75	-304.0	-304.0	-304.0
chrX	1767391	1770496	1767363	1770570	JUNC00000258	3	+	28	74	-304.0	-304.0	-304.0
chrX	1771629	1781473	1771562	1781493	JUNC00000259	2	+	67	20	-304.0	-304.0	-304.0
chrX	1776384	1781473	1776317	1781548	JUNC00000260	5	+	67	75	-304.0	-304.0	-304.0
chrX	1776482	1781076	1776458	1781128	JUNC00000261	1	+	24	52	-304.0	-304.0	-304.0
chrX	1811257	1850064	1811220	1850103	JUNC00000262	1	+	37	39	118.0	122.0	122.0
chrX	1877109	1922869	1877056	1922892	JUNC00000263	1	+	53	23	-304.0	-304.0	-304.0
chrX	2156859	2160781	2156824	2160822	JUNC00000264	1	-	35	41	-304.0	-304.0	-304.0
chrX	2174057	2179533	2174039	2179591	JUNC00000265	1	-	18	58	-304.0	-304.0	-304.0
chrX	2202125	2289212	2202106	2289269	JUNC00000266	1	+	19	57	112.0	112.0	112.0
chrX	2211614	2243022	2211597	2243095	JUNC00000267	2	-	17	73	-304.0	-304.0	-304.0
chrX	2221229	2243022	2221154	2243095	JUNC00000268	73	-	75	73	-304.0	-304.0	-304.0
chrX	2236034	2250084	2236005	2250131	JUNC00000269	1	-	29	47	-304.0	102.0	102.0
chrX	2241843	2250097	2241807	2250137	JUNC00000270	1	+	36	40	-304.0	-304.0	-304.0
chrX	2243230	2266739	2243157	2266813	JUNC00000271	72	-	73	74	-304.0	-304.0	-304.0
chrX	2266947	2291501	2266876	2291576	JUNC00000272	81	-	71	75	-304.0	-304.0	-304.0
chrX	2291603	2392353	2291546	2392426	JUNC00000274	7	-	57	73	-304.0	-304.0	-304.0
chrX	2291603	2408744	2291529	2408813	JUNC00000273	34	-	74	69	-304.0	-304.0	-304.0
chrX	2291603	2425196	2291563	2425248	JUNC00000275	2	-	40	52	-304.0	-304.0	-304.0
chrX	2321916	2326831	2321875	2326854	JUNC00000277	1	+	41	23	-304.0	-304.0	-304.0
chrX	2338255	2358871	2338226	2358909	JUNC00000278	1	-	29	38	-304.0	-304.0	-304.0
chrX	2392160	2392353	2392101	2392404	JUNC00000279	4	-	59	51	-304.0	-304.0	-304.0
chrX	2392474	2408744	2392410	2408809	JUNC00000281	11	-	64	65	-304.0	-304.0	-304.0
chrX	2392474	2425196	2392408	2425262	JUNC00000280	8	-	66	66	-304.0	-304.0	-304.0
chrX	2393506	2393578	2393463	2393611	JUNC00000282	1	-	43	33	-304.0	-304.0	-304.0
chrX	2408813	2425196	2408744	2425270	JUNC00000276	45	-	69	74	-304.0	-304.0	-304.0
chrX	2425304	2500816	2425234	2500872	JUNC00000283	15	-	70	56	-304.0	-304.0	-304.0
chrX	2484203	2519165	2484165	2519203	JUNC00000284	1	-	38	38	-304.0	-304.0	-304.0
chrX	2487484	2510428	2487428	2510448	JUNC00000285	1	-	56	20	-304.0	-304.0	-304.0
chrX	2488271	2535926	2488202	2535941	JUNC00000286	11	+	69	15	106.0	-304.0	106.0
chrX	2488271	2539383	2488202	2539398	JUNC00000287	11	+	69	15	-304.0	122.0	122.0
chrX	2490772	2498205	2490747	2498245	JUNC00000290	1	-	25	40	-304.0	-304.0	-304.0
chrX	2490772	2500310	2490697	2500363	JUNC00000289	4	-	75	53	-304.0	-304.0	-304.0
chrX	2490772	2500816	2490697	2500877	JUNC00000288	9	-	75	61	-304.0	-304.0	-304.0
chrX	2524784	2529897	2524731	2529931	JUNC00000291	2	-	53	34	-304.0	-304.0	-304.0
chrX	2566553	2567084	2566502	2567109	JUNC00000292	1	-	51	25	-304.0	-304.0	-304.0
chrX	2567292	2570010	2567258	2570052	JUNC00000295	1	-	34	42	-304.0	-304.0	-304.0
chrX	2567292	2583843	2567222	2583893	JUNC00000293	3	-	70	50	-304.0	-304.0	-304.0
chrX	2567292	2609105	2567249	2609135	JUNC00000294	1	-	43	30	-304.0	-304.0	-304.0
chrX	2593847	2622187	2593828	2622255	JUNC00000296	2	+	19	68	-304.0	-304.0	-304.0
chrX	2606296	2612904	2606255	2612939	JUNC00000297	1	+	41	35	104.0	-304.0	104.0
chrX	2609481	2610995	2609431	2611042	JUNC00000298	14	+	50	47	-304.0	-304.0	-304.0
chrX	2611038	2612149	2610995	2612220	JUNC00000299	24	+	43	71	-304.0	-304.0	-304.0
chrX	2612218	2615815	2612149	2615886	JUNC00000300	40	+	69	71	-304.0	-304.0	-304.0
chrX	2612218	2618739	2612160	2618757	JUNC00000301	1	+	58	18	-304.0	-304.0	-304.0
chrX	2615969	2618532	2615912	2618551	JUNC00000303	1	+	57	19	-304.0	-304.0	-304.0
chrX	2615969	2618739	2615899	2618784	JUNC00000302	31	+	70	45	-304.0	-304.0	-304.0
chrX	2618784	2619428	2618739	2619481	JUNC00000304	20	+	45	53	-304.0	-304.0	-304.0
chrX	2619497	2622689	2619429	2622734	JUNC00000305	17	+	68	45	-304.0	-304.0	-304.0
chrX	2619497	2623384	2619444	2623453	JUNC00000306	8	+	53	69	-304.0	-304.0	-304.0
chrX	2622734	2623384	2622689	2623453	JUNC00000307	17	+	45	69	-304.0	-304.0	-304.0
chrX	2623453	2626596	2623384	2626642	JUNC00000308	32	+	69	46	-304.0	-304.0	-304.0
chrX	2626642	2637973	2626596	2638032	JUNC00000309	16	+	46	59	-304.0	-304.0	-304.0
chrX	2626642	2647511	2626613	2647558	JUNC00000311	1	+	29	47	-304.0	-304.0	-304.0
chrX	2626642	2658443	2626624	2658499	JUNC00000312	1	+	18	56	-304.0	-304.0	-304.0
chrX	2626642	2714421	2626596	2714448	JUNC00000310	1	+	46	27	-304.0	-304.0	-304.0
chrX	2636719	2645271	2636700	2645328	JUNC00000313	1	+	19	57	-304.0	-304.0	-304.0
chrX	2691427	2714421	2691352	2714486	JUNC00000314	614	+	75	65	-304.0	-304.0	-304.0
chrX	2691695	2714421	2691654	2714454	JUNC00000317	1	+	41	33	-304.0	-304.0	-304.0
chrX	2710314	2714421	2710281	2714454	JUNC00000318	2	+	33	33	-304.0	-304.0	-304.0
chrX	2714454	2717604	2714405	2717667	JUNC00000315	1016	+	49	63	-304.0	-304.0	-304.0
chrX	2714454	2719660	2714421	2719705	JUNC00000316	57	+	33	45	-304.0	-304.0	-304.0
chrX	2716113	2725708	2716096	2725758	JUNC00000321	1	+	17	50	-304.0	120.0	120.0
chrX	2717652	2719660	2717603	2719709	JUNC00000319	1191	+	49	49	-304.0	-304.0	-304.0
chrX	2719705	2720355	2719643	2720428	JUNC00000320	1553	+	62	73	-304.0	-304.0	-304.0
chrX	2720424	2722626	2720354	2722675	JUNC00000322	1507	+	70	49	-304.0	-304.0	-304.0
chrX	2720424	2722630	2720372	2722674	JUNC00000323	2	+	52	44	-304.0	-304.0	-304.0
chrX	2722674	2723313	2722625	2723365	JUNC00000324	1181	+	49	52	-304.0	-304.0	-304.0
chrX	2723364	2726259	2723311	2726334	JUNC00000326	885	+	53	75	-304.0	-304.0	-304.0
chrX	2723364	2738199	2723313	2738256	JUNC00000325	28	+	51	57	-304.0	-304.0	-304.0
chrX	2726373	2733356	2726300	2733417	JUNC00000330	4	+	73	61	-304.0	-304.0	-304.0
chrX	2726373	2738199	2726298	2738257	JUNC00000328	509	+	75	58	-304.0	-304.0	-304.0
chrX	2726373	2738202	2726300	2738256	JUNC00000329	61	+	73	54	-304.0	-304.0	-304.0
chrX	2726373	2740778	2726342	2740853	JUNC00000331	3	+	31	75	-304.0	-304.0	-304.0
chrX	2738256	2740778	2738198	2740853	JUNC00000327	607	+	58	75	-304.0	-304.0	-304.0
chrX	2861722	2881051	2861672	2881077	JUNC00000332	1	+	50	26	-304.0	-304.0	-304.0
chrX	2876878	2911596	2876847	2911641	JUNC00000333	1	+	31	45	122.0	-304.0	122.0
chrX	2907632	2908720	2907565	2908767	JUNC00000334	9	-	67	47	-304.0	-304.0	-304.0
chrX	2908842	2909816	2908772	2909862	JUNC00000335	5	-	70	46	-304.0	-304.0	-304.0
chrX	2909979	2910658	2909920	2910729	JUNC00000336	5	-	59	71	-304.0	-304.0	-304.0
chrX	2910793	2915555	2910724	2915627	JUNC00000337	8	-	69	72	-304.0	-304.0	-304.0
chrX	2915692	2917803	2915617	2917877	JUNC00000338	6	-	75	74	-304.0	-304.0	-304.0
chrX	2918227	2920600	2918160	2920672	JUNC00000339	12	-	67	72	-304.0	-304.0	-304.0
chrX	2920723	2921902	2920650	2921973	JUNC00000340	23	-	73	71	-304.0	-304.0	-304.0
chrX	2922024	2925615	2921952	2925690	JUNC00000341	15	-	72	75	-304.0	-304.0	-304.0
chrX	2935190	2936741	2935141	2936768	JUNC00000342	1	-	49	27	-304.0	-304.0	-304.0
chrX	2996737	3049979	2996709	3050026	JUNC00000343	1	-	28	47	-304.0	-304.0	-304.0
chrX	3029779	3078748	3029725	3078770	JUNC00000344	1	-	54	22	-304.0	114.0	114.0
chrX	3223952	3265925	3223931	3265980	JUNC00000345	1	+	21	55	-304.0	-304.0	-304.0
chrX	3608945	3612176	3608870	3612251	JUNC00000346	37	-	75	75	-304.0	-304.0	-304.0
chrX	3611334	3612176	3611265	3612238	JUNC00000347	10	-	69	62	-304.0	-304.0	-304.0
chrX	3612325	3615814	3612252	3615887	JUNC00000348	40	-	73	73	-304.0	-304.0	-304.0
chrX	3615892	3621258	3615817	3621316	JUNC00000349	55	-	75	58	-304.0	-304.0	-304.0
chrX	3621316	3626418	3621258	3626492	JUNC00000350	55	-	58	74	-304.0	-304.0	-304.0
chrX	3621316	3641851	3621296	3641907	JUNC00000351	1	-	20	56	-304.0	-304.0	-304.0
chrX	3626514	3641851	3626442	3641925	JUNC00000352	36	-	72	74	-304.0	-304.0	-304.0
chrX	3626514	3655148	3626448	3655223	JUNC00000353	5	-	66	75	-304.0	-304.0	-304.0
chrX	3641971	3655148	3641897	3655223	JUNC00000354	56	-	74	75	-304.0	-304.0	-304.0
chrX	3655412	3674597	3655338	3674672	JUNC00000355	58	-	74	75	-304.0	-304.0	-304.0
chrX	3674766	3712485	3674736	3712531	JUNC00000357	1	-	30	46	-304.0	-304.0	-304.0
chrX	3674766	3713087	3674693	3713159	JUNC00000356	9	-	73	72	-304.0	-304.0	-304.0
chrX	3768644	3828003	3768626	3828060	JUNC00000358	2	+	18	57	-304.0	-304.0	-304.0
chrX	3817778	3818441	3817713	3818501	JUNC00000359	48	-	65	60	-304.0	-304.0	-304.0
chrX	3818500	3818656	3818437	3818703	JUNC00000361	19	-	63	47	-304.0	-304.0	-304.0
chrX	3818500	3822373	3818441	3822439	JUNC00000360	9	-	59	66	-304.0	-304.0	-304.0
chrX	3818703	3822373	3818656	3822444	JUNC00000363	5	-	47	71	-304.0	-304.0	-304.0
chrX	3818703	3828505	3818656	3828580	JUNC00000362	3	-	47	75	-304.0	-304.0	-304.0
chrX	3820117	3860789	3820082	3860828	JUNC00000364	2	-	35	39	-304.0	-304.0	-304.0
chrX	3821582	3822373	3821541	3822409	JUNC00000365	2	-	41	36	-304.0	-304.0	-304.0
chrX	3822285	3822373	3822235	3822438	JUNC00000366	10	-	50	65	-304.0	-304.0	-304.0
chrX	3822562	3825087	3822513	3825114	JUNC00000369	1	-	49	27	-304.0	-304.0	-304.0
chrX	3822580	3824233	3822511	3824304	JUNC00000368	8	-	69	71	-304.0	-304.0	-304.0
chrX	3822580	3825087	3822511	3825161	JUNC00000367	46	-	69	74	-304.0	-304.0	-304.0
chrX	3822580	3826600	3822520	3826647	JUNC00000370	2	-	60	47	-304.0	-304.0	-304.0
chrX	3822580	3829363	3822560	3829392	JUNC00000371	1	-	20	29	-304.0	-304.0	-304.0
chrX	3823327	3861743	3823252	3861775	JUNC00000373	5	+	75	32	126.0	130.0	130.0
chrX	3825231	3826484	3825183	3826545	JUNC00000374	5	-	48	61	-304.0	-304.0	-304.0
chrX	3825231	3826600	3825168	3826656	JUNC00000375	9	-	63	56	-304.0	-304.0	-304.0
chrX	3825231	3828535	3825194	3828574	JUNC00000376	1	-	37	39	-304.0	-304.0	-304.0
chrX	3826580	3826661	3826523	3826680	JUNC00000377	1	-	57	19	-304.0	-304.0	-304.0
chrX	3826661	3865074	3826639	3865128	JUNC00000378	2	-	22	54	140.0	144.0	144.0
chrX	3826729	3828505	3826696	3828545	JUNC00000379	3	-	33	40	-304.0	-304.0	-304.0
chrX	3829392	3833255	3829317	3833310	JUNC00000382	8	-	75	55	-304.0	-304.0	-304.0
chrX	3829392	3842740	3829317	3842792	JUNC00000380	10	-	75	52	-304.0	-304.0	-304.0
chrX	3829392	3843340	3829317	3843408	JUNC00000372	35	-	75	68	-304.0	-304.0	-304.0
chrX	3829392	3854691	3829317	3854710	JUNC00000381	2	-	75	19	-304.0	-304.0	-304.0
chrX	3847307	3853553	3847253	3853575	JUNC00000383	1	-	54	22	-304.0	-304.0	-304.0
chrX	3848490	3850212	3848442	3850240	JUNC00000385	1	-	48	28	-304.0	-304.0	-304.0
chrX	3848490	3854691	3848424	3854744	JUNC00000384	4	-	66	53	-304.0	-304.0	-304.0
chrX	3851154	3889508	3851125	3889555	JUNC00000386	2	+	29	47	-304.0	-304.0	-304.0
chrX	3853789	3854691	3853757	3854751	JUNC00000387	6	-	32	60	-304.0	-304.0	-304.0
chrX	3854927	3860789	3854854	3860860	JUNC00000388	33	-	73	71	-304.0	-304.0	-304.0
chrX	3860701	3860789	3860651	3860863	JUNC00000389	12	-	50	74	-304.0	-304.0	-304.0
chrX	3860978	3863501	3860929	3863528	JUNC00000392	2	-	49	27	-304.0	-304.0	-304.0
chrX	3860996	3862649	3860927	3862720	JUNC00000391	9	-	69	71	-304.0	-304.0	-304.0
chrX	3860996	3863501	3860921	3863574	JUNC00000390	58	-	75	73	-304.0	-304.0	-304.0
chrX	3860996	3865013	3860936	3865060	JUNC00000393	4	-	60	47	-304.0	-304.0	-304.0
chrX	3863645	3865013	3863601	3865088	JUNC00000397	7	-	44	75	-304.0	-304.0	-304.0
chrX	3863645	3865074	3863583	3865143	JUNC00000396	8	-	62	69	-304.0	-304.0	-304.0
chrX	3863645	3866921	3863574	3866953	JUNC00000395	6	-	71	32	-304.0	-304.0	-304.0
chrX	3863645	3866949	3863573	3866988	JUNC00000394	3	-	72	39	-304.0	-304.0	-304.0
chrX	3865142	3866949	3865071	3867007	JUNC00000398	4	-	71	58	-304.0	-304.0	-304.0
chrX	3867806	3871674	3867764	3871729	JUNC00000401	6	-	42	55	-304.0	-304.0	-304.0
chrX	3867806	3881164	3867744	3881216	JUNC00000400	9	-	62	52	-304.0	-304.0	-304.0
chrX	3867806	3893115	3867742	3893134	JUNC00000399	4	-	64	19	-304.0	-304.0	-304.0
chrX	3871805	3872216	3871782	3872269	JUNC00000402	2	-	23	53	-304.0	-304.0	-304.0
chrX	3885732	3891977	3885678	3891999	JUNC00000403	2	-	54	22	-304.0	-304.0	-304.0
chrX	3886915	3888637	3886867	3888665	JUNC00000404	2	-	48	28	-304.0	-304.0	-304.0
chrX	3889579	3927939	3889550	3927986	JUNC00000405	1	+	29	47	-304.0	-304.0	-304.0
chrX	3890552	3905347	3890525	3905410	JUNC00000406	2	-	27	63	-304.0	-304.0	-304.0
chrX	3893351	3899215	3893278	3899286	JUNC00000407	29	-	73	71	-304.0	-304.0	-304.0
chrX	3893351	3905347	3893295	3905371	JUNC00000408	3	-	56	24	-304.0	-304.0	-304.0
chrX	3899127	3899215	3899077	3899289	JUNC00000409	9	-	50	74	-304.0	-304.0	-304.0
chrX	3899404	3901927	3899355	3901954	JUNC00000412	3	-	49	27	-304.0	-304.0	-304.0
chrX	3899422	3901075	3899353	3901146	JUNC00000411	10	-	69	71	-304.0	-304.0	-304.0
chrX	3899422	3901927	3899347	3902000	JUNC00000410	65	-	75	73	-304.0	-304.0	-304.0
chrX	3899422	3903440	3899362	3903487	JUNC00000413	6	-	60	47	-304.0	-304.0	-304.0
chrX	3902071	3903440	3902027	3903515	JUNC00000416	9	-	44	75	-304.0	-304.0	-304.0
chrX	3902071	3903501	3902032	3903570	JUNC00000417	9	-	39	69	-304.0	-304.0	-304.0
chrX	3902071	3905347	3902000	3905379	JUNC00000415	8	-	71	32	-304.0	-304.0	-304.0
chrX	3902071	3905375	3901999	3905414	JUNC00000414	5	-	72	39	-304.0	-304.0	-304.0
chrX	3906232	3910106	3906190	3910161	JUNC00000420	3	-	42	55	-304.0	-304.0	-304.0
chrX	3906232	3919593	3906176	3919645	JUNC00000419	4	-	56	52	-304.0	-304.0	-304.0
chrX	3906232	3931546	3906168	3931565	JUNC00000418	4	-	64	19	-304.0	-304.0	-304.0
chrX	3924160	3930408	3924106	3930430	JUNC00000421	3	-	54	22	-304.0	-304.0	-304.0
chrX	3925343	3927065	3925295	3927093	JUNC00000422	3	-	48	28	-304.0	-304.0	-304.0
chrX	4513114	4513788	4513094	4513844	JUNC00000423	1	+	20	56	-304.0	-304.0	-304.0
chrX	4703436	4713650	4703405	4713688	JUNC00000424	1	-	31	38	-304.0	-304.0	-304.0
chrX	4730515	4760100	4730463	4760124	JUNC00000425	1	+	52	24	-304.0	-304.0	-304.0
chrX	5893666	5903076	5893591	5903131	JUNC00000426	4	-	75	55	-304.0	-304.0	-304.0
chrX	5903866	5909053	5903821	5909101	JUNC00000427	3	-	45	48	-304.0	-304.0	-304.0
chrX	6029432	6150994	6029369	6151066	JUNC00000428	5	-	63	72	-304.0	-304.0	-304.0
chrX	6151771	6226634	6151717	6226656	JUNC00000429	1	-	54	22	-304.0	-304.0	-304.0
chrX	6151771	6228540	6151743	6228588	JUNC00000430	1	-	28	48	-304.0	-304.0	-304.0
chrX	6534203	6534395	6534165	6534433	JUNC00000431	1	-	38	38	-304.0	-304.0	-304.0
chrX	6978343	7077219	6978292	7077244	JUNC00000432	1	-	51	25	-304.0	-304.0	-304.0
chrX	7050472	7077219	7050397	7077293	JUNC00000433	89	-	75	74	-304.0	-304.0	-304.0
chrX	7050472	7105619	7050397	7105661	JUNC00000434	3	-	75	42	-304.0	-304.0	-304.0
chrX	7077449	7105619	7077375	7105694	JUNC00000435	90	-	74	75	-304.0	-304.0	-304.0
chrX	7077449	7105748	7077395	7105806	JUNC00000436	2	-	54	58	-304.0	-304.0	-304.0
chrX	7105838	7116965	7105784	7116987	JUNC00000439	1	-	54	22	-304.0	-304.0	-304.0
chrX	7105838	7148025	7105769	7148051	JUNC00000438	2	-	69	26	-304.0	-304.0	-304.0
chrX	7105838	7148052	7105765	7148127	JUNC00000437	47	-	73	75	-304.0	-304.0	-304.0
chrX	7117034	7148052	7116968	7148092	JUNC00000440	3	-	66	40	-304.0	-304.0	-304.0
chrX	7147606	7190883	7147545	7190934	JUNC00000441	5	+	61	51	-304.0	-304.0	-304.0
chrX	7148083	7190879	7148008	7190939	JUNC00000442	7	+	75	60	-304.0	-304.0	-304.0
chrX	7191008	7253195	7190934	7253270	JUNC00000443	26	+	74	75	-304.0	-304.0	-304.0
chrX	7252341	7252494	7252301	7252530	JUNC00000444	1	+	40	36	-304.0	-304.0	-304.0
chrX	7252718	7253195	7252680	7253233	JUNC00000445	1	+	38	38	-304.0	-304.0	-304.0
chrX	7253336	7257241	7253261	7257316	JUNC00000446	24	+	75	75	-304.0	-304.0	-304.0
chrX	7257363	7257465	7257303	7257534	JUNC00000447	27	+	60	69	-304.0	-304.0	-304.0
chrX	7257588	7259348	7257515	7259423	JUNC00000448	30	+	73	75	-304.0	-304.0	-304.0
chrX	7259772	7275950	7259697	7276020	JUNC00000449	32	+	75	70	-304.0	-304.0	-304.0
chrX	7276087	7305045	7276016	7305120	JUNC00000450	38	+	71	75	-304.0	-304.0	-304.0
chrX	7305183	7325338	7305108	7325411	JUNC00000451	49	+	75	73	-304.0	-304.0	-304.0
chrX	7325498	7333985	7325423	7334058	JUNC00000452	37	+	75	73	-304.0	-304.0	-304.0
chrX	7334107	7349887	7334033	7349962	JUNC00000453	35	+	74	75	-304.0	-304.0	-304.0
chrX	7843305	7843497	7843267	7843535	JUNC00000454	1	+	38	38	-304.0	-304.0	-304.0
chrX	7900817	7901988	7900745	7902062	JUNC00000455	38	-	72	74	-304.0	-304.0	-304.0
chrX	7900843	7901988	7900798	7902019	JUNC00000456	1	-	45	31	-304.0	-304.0	-304.0
chrX	7902141	7912027	7902070	7912094	JUNC00000457	20	-	71	67	-304.0	-304.0	-304.0
chrX	7912093	7921712	7912027	7921782	JUNC00000458	50	-	66	70	-304.0	-304.0	-304.0
chrX	7921848	7922003	7921774	7922075	JUNC00000459	44	-	74	72	-304.0	-304.0	-304.0
chrX	7922098	7925939	7922023	7926014	JUNC00000460	46	-	75	75	-304.0	-304.0	-304.0
chrX	7922098	7927670	7922055	7927703	JUNC00000461	1	-	43	33	-304.0	-304.0	-304.0
chrX	7926132	7927285	7926057	7927360	JUNC00000462	34	-	75	75	-304.0	-304.0	-304.0
chrX	7926132	7927670	7926088	7927702	JUNC00000464	1	-	44	32	-304.0	-304.0	-304.0
chrX	7926132	7927685	7926078	7927707	JUNC00000463	1	-	54	22	-304.0	-304.0	-304.0
chrX	7929413	7965598	7929385	7965646	JUNC00000465	1	+	28	48	-304.0	-304.0	-304.0
chrX	8062668	8228334	8062621	8228363	JUNC00000466	1	+	47	29	-304.0	-304.0	-304.0
chrX	8170349	8170541	8170311	8170579	JUNC00000467	1	-	38	38	-304.0	-304.0	-304.0
chrX	8466059	8466359	8466005	8466381	JUNC00000468	1	+	54	22	-304.0	-304.0	-304.0
chrX	8466119	8466359	8466065	8466381	JUNC00000469	1	+	54	22	-304.0	-304.0	-304.0
chrX	8466209	8466359	8466155	8466381	JUNC00000470	1	+	54	22	-304.0	-304.0	-304.0
chrX	8554098	8568231	8554060	8568269	JUNC00000471	1	-	38	38	-304.0	-304.0	-304.0
chrX	8570704	8585266	8570650	8585288	JUNC00000472	1	-	54	22	-304.0	-304.0	-304.0
chrX	8615465	8621288	8615428	8621327	JUNC00000473	1	-	37	39	-304.0	-304.0	-304.0
chrX	9463462	9481524	9463444	9481582	JUNC00000475	1	+	18	58	-304.0	-304.0	-304.0
chrX	9463462	9501779	9463438	9501831	JUNC00000474	1	+	24	52	-304.0	-304.0	-304.0
chrX	9465447	9501779	9465413	9501849	JUNC00000476	12	+	34	70	-304.0	-304.0	-304.0
chrX	9466457	9470658	9466427	9470704	JUNC00000479	1	+	30	46	-304.0	-304.0	-304.0
chrX	9466457	9473294	9466399	9473312	JUNC00000478	1	+	58	18	-304.0	-304.0	-304.0
chrX	9481638	9501779	9481575	9501827	JUNC00000480	2	+	63	48	-304.0	-304.0	-304.0
chrX	9501849	9640272	9501779	9640347	JUNC00000477	43	+	70	75	-304.0	-304.0	-304.0
chrX	9640360	9653544	9640285	9653619	JUNC00000481	30	+	75	75	-304.0	-304.0	-304.0
chrX	9640360	9654214	9640286	9654285	JUNC00000482	25	+	74	71	-304.0	-304.0	-304.0
chrX	9653689	9654214	9653618	9654288	JUNC00000483	24	+	71	74	-304.0	-304.0	-304.0
chrX	9654322	9684042	9654247	9684117	JUNC00000484	54	+	75	75	-304.0	-304.0	-304.0
chrX	9654322	9688016	9654264	9688034	JUNC00000485	1	+	58	18	-304.0	-304.0	-304.0
chrX	9684188	9688016	9684113	9688089	JUNC00000486	56	+	75	73	-304.0	-304.0	-304.0
chrX	9688275	9691578	9688207	9691647	JUNC00000487	62	+	68	69	-304.0	-304.0	-304.0
chrX	9691711	9692112	9691636	9692187	JUNC00000488	81	+	75	75	-304.0	-304.0	-304.0
chrX	9692254	9693148	9692184	9693215	JUNC00000489	69	+	70	67	-304.0	-304.0	-304.0
chrX	9693212	9693321	9693148	9693396	JUNC00000490	80	+	64	75	-304.0	-304.0	-304.0
chrX	9693419	9697368	9693345	9697429	JUNC00000491	72	+	74	61	-304.0	-304.0	-304.0
chrX	9697429	9704992	9697368	9705065	JUNC00000492	81	+	61	73	-304.0	-304.0	-304.0
chrX	9705114	9709247	9705040	9709322	JUNC00000493	75	+	74	75	-304.0	-304.0	-304.0
chrX	9709322	9709632	9709247	9709707	JUNC00000494	63	+	75	75	-304.0	-304.0	-304.0
chrX	9709760	9711610	9709686	9711685	JUNC00000495	71	+	74	75	-304.0	-304.0	-304.0
chrX	9711776	9714901	9711701	9714973	JUNC00000496	69	+	75	72	-304.0	-304.0	-304.0
chrX	9715003	9716219	9714930	9716292	JUNC00000497	74	+	73	73	-304.0	-304.0	-304.0
chrX	9725670	9729460	9725636	9729502	JUNC00000498	1	+	34	42	-304.0	-304.0	-304.0
chrX	9729821	9740781	9729767	9740803	JUNC00000499	1	+	54	22	-304.0	-304.0	-304.0
chrX	9857619	9930973	9857582	9931010	JUNC00000500	2	-	37	37	130.0	130.0	130.0
chrX	9995167	10018731	9995130	10018770	JUNC00000501	1	+	37	39	-304.0	-304.0	-304.0
chrX	10015858	10063444	10015792	10063519	JUNC00000502	5	+	66	75	-304.0	-304.0	-304.0
chrX	10063554	10067286	10063481	10067348	JUNC00000503	11	+	73	62	-304.0	-304.0	-304.0
chrX	10067490	10078798	10067423	10078868	JUNC00000504	12	+	67	70	-304.0	-304.0	-304.0
chrX	10078875	10079724	10078805	10079797	JUNC00000505	10	+	70	73	-304.0	-304.0	-304.0
chrX	10078875	10079732	10078838	10079771	JUNC00000506	1	+	37	39	-304.0	-304.0	-304.0
chrX	10079804	10090770	10079734	10090831	JUNC00000507	9	+	70	61	-304.0	-304.0	-304.0
chrX	10090900	10094131	10090828	10094204	JUNC00000508	14	+	72	73	-304.0	-304.0	-304.0
chrX	10094281	10098505	10094209	10098560	JUNC00000509	6	+	72	55	-304.0	-304.0	-304.0
chrX	10098579	10103040	10098522	10103095	JUNC00000511	2	+	57	55	-304.0	-304.0	-304.0
chrX	10098579	10109777	10098518	10109844	JUNC00000510	8	+	61	67	-304.0	-304.0	-304.0
chrX	10110020	10116417	10109954	10116485	JUNC00000512	5	+	66	68	-304.0	-304.0	-304.0
chrX	10116507	10117123	10116432	10117183	JUNC00000513	5	+	75	60	-304.0	-304.0	-304.0
chrX	10117689	10122618	10117651	10122674	JUNC00000514	5	+	38	56	-304.0	-304.0	-304.0
chrX	10122739	10124264	10122667	10124329	JUNC00000515	17	+	72	65	-304.0	-304.0	-304.0
chrX	10124339	10125023	10124265	10125091	JUNC00000516	31	+	74	68	-304.0	-304.0	-304.0
chrX	10125110	10126113	10125036	10126182	JUNC00000517	18	+	74	69	-304.0	-304.0	-304.0
chrX	10125110	10127987	10125057	10128010	JUNC00000518	1	+	53	23	-304.0	-304.0	-304.0
chrX	10126306	10127987	10126232	10128061	JUNC00000519	36	+	74	74	-304.0	-304.0	-304.0
chrX	10128161	10128556	10128089	10128625	JUNC00000520	15	+	72	69	-304.0	-304.0	-304.0
chrX	10128708	10129955	10128635	10130027	JUNC00000521	19	+	73	72	-304.0	-304.0	-304.0
chrX	10130121	10134431	10130048	10134497	JUNC00000522	23	+	73	66	-304.0	-304.0	-304.0
chrX	10134596	10136632	10134524	10136704	JUNC00000523	22	+	72	72	-304.0	-304.0	-304.0
chrX	10136725	10138708	10136656	10138782	JUNC00000524	19	+	69	74	-304.0	-304.0	-304.0
chrX	10138936	10139412	10138869	10139482	JUNC00000525	9	+	67	70	-304.0	-304.0	-304.0
chrX	10139540	10141434	10139465	10141502	JUNC00000526	20	+	75	68	-304.0	-304.0	-304.0
chrX	10157100	10158288	10157040	10158351	JUNC00000527	3	+	60	63	-304.0	-304.0	-304.0
chrX	10185176	10187514	10185121	10187584	JUNC00000528	5	+	55	70	-304.0	-304.0	-304.0
chrX	10187614	10194910	10187552	10194983	JUNC00000529	7	+	62	73	-304.0	-304.0	-304.0
chrX	10195098	10197938	10195062	10197978	JUNC00000530	1	+	36	40	-304.0	-304.0	-304.0
chrX	10198061	10206357	10198019	10206421	JUNC00000531	4	+	42	64	-304.0	-304.0	-304.0
chrX	10206564	10206695	10206504	10206764	JUNC00000532	6	+	60	69	-304.0	-304.0	-304.0
chrX	10206776	10208044	10206719	10208101	JUNC00000533	4	+	57	57	-304.0	-304.0	-304.0
chrX	10208590	10212466	10208517	10212541	JUNC00000534	14	+	73	75	-304.0	-304.0	-304.0
chrX	10212653	10213680	10212579	10213742	JUNC00000535	4	+	74	62	-304.0	-304.0	-304.0
chrX	10214079	10220660	10214005	10220727	JUNC00000536	8	+	74	67	-304.0	-304.0	-304.0
chrX	10220877	10233493	10220803	10233566	JUNC00000537	9	+	74	73	-304.0	-304.0	-304.0
chrX	10251008	10305612	10250975	10305667	JUNC00000538	2	+	33	55	144.0	136.0	144.0
chrX	10469840	10474622	10469789	10474647	JUNC00000539	1	-	51	25	-304.0	-304.0	-304.0
chrX	10501559	10523091	10501517	10523125	JUNC00000540	1	-	42	34	-304.0	-304.0	-304.0
chrX	10523187	10566887	10523164	10566940	JUNC00000541	1	-	23	53	-304.0	-304.0	-304.0
chrX	10860346	11038602	10860296	11038628	JUNC00000542	1	-	50	26	-304.0	-304.0	-304.0
chrX	11025266	11029722	11025241	11029763	JUNC00000543	1	-	25	41	-304.0	-304.0	-304.0
chrX	11056041	11106900	11055974	11106945	JUNC00000544	3	-	67	45	-304.0	-304.0	-304.0
chrX	11106990	11110882	11106941	11110937	JUNC00000545	2	-	49	55	-304.0	-304.0	-304.0
chrX	11111460	11112018	11111412	11112044	JUNC00000546	1	+	48	26	-304.0	-304.0	-304.0
chrX	11111518	11112018	11111446	11112091	JUNC00000547	49	+	72	73	-304.0	-304.0	-304.0
chrX	11112160	11114834	11112087	11114909	JUNC00000548	123	+	73	75	-304.0	-304.0	-304.0
chrX	11114986	11117266	11114911	11117339	JUNC00000549	151	+	75	73	-304.0	-304.0	-304.0
chrX	11115960	11117266	11115909	11117291	JUNC00000550	1	+	51	25	-304.0	-304.0	-304.0
chrX	11117415	11118500	11117340	11118574	JUNC00000551	139	+	75	74	-304.0	-304.0	-304.0
chrX	11118620	11120906	11118545	11120981	JUNC00000552	134	+	75	75	-304.0	-304.0	-304.0
chrX	11120993	11121611	11120919	11121686	JUNC00000553	85	+	74	75	-304.0	-304.0	-304.0
chrX	11139530	11142232	11139455	11142300	JUNC00000554	7	-	75	68	-304.0	-304.0	-304.0
chrX	11142313	11143979	11142241	11144048	JUNC00000555	11	-	72	69	-304.0	-304.0	-304.0
chrX	11144248	11156528	11144176	11156603	JUNC00000556	12	-	72	75	-304.0	-304.0	-304.0
chrX	11148719	11156528	11148717	11156603	JUNC00000557	5	-	2	75	-304.0	-304.0	-304.0
chrX	11156626	11169504	11156553	11169577	JUNC00000558	13	-	73	73	-304.0	-304.0	-304.0
chrX	11169684	11178099	11169614	11178161	JUNC00000559	20	-	70	62	-304.0	-304.0	-304.0
chrX	11178248	11179301	11178178	11179373	JUNC00000560	15	-	70	72	-304.0	-304.0	-304.0
chrX	11179452	11182062	11179378	11182118	JUNC00000561	20	-	74	56	-304.0	-304.0	-304.0
chrX	11182118	11186235	11182062	11186305	JUNC00000562	13	-	56	70	-304.0	-304.0	-304.0
chrX	11186431	11188727	11186366	11188792	JUNC00000563	18	-	65	65	-304.0	-304.0	-304.0
chrX	11188984	11196924	11188910	11196997	JUNC00000564	22	-	74	73	-304.0	-304.0	-304.0
chrX	11196996	11254547	11196924	11254622	JUNC00000565	22	-	72	75	-304.0	-304.0	-304.0
chrX	11254707	11290382	11254634	11290384	JUNC00000566	3	-	73	2	-304.0	-304.0	-304.0
chrX	11254707	11664240	11254661	11664306	JUNC00000567	3	-	46	66	-304.0	-304.0	-304.0
chrX	11665864	11665999	11665833	11666072	JUNC00000568	3	-	31	73	-304.0	-304.0	-304.0
chrX	11665912	11665999	11665867	11666030	JUNC00000569	1	-	45	31	-304.0	-304.0	-304.0
chrX	11758365	11759792	11758293	11759864	JUNC00000570	64	+	72	72	-304.0	-304.0	-304.0
chrX	11759712	11759792	11759665	11759837	JUNC00000571	3	+	47	45	-304.0	-304.0	-304.0
chrX	11759875	11760402	11759800	11760477	JUNC00000572	111	+	75	75	-304.0	-304.0	-304.0
chrX	11760233	11760402	11760202	11760455	JUNC00000573	2	+	31	53	-304.0	-304.0	-304.0
chrX	11760309	11760402	11760236	11760465	JUNC00000574	10	+	73	63	-304.0	-304.0	-304.0
chrX	11760498	11760836	11760423	11760910	JUNC00000575	127	+	75	74	-304.0	-304.0	-304.0
chrX	11760937	11761499	11760863	11761573	JUNC00000576	147	+	74	74	-304.0	-304.0	-304.0
chrX	11761582	11762129	11761508	11762204	JUNC00000577	166	+	74	75	-304.0	-304.0	-304.0
chrX	11762252	11762836	11762177	11762911	JUNC00000578	148	+	75	75	-304.0	-304.0	-304.0
chrX	11762256	11763920	11762220	11763938	JUNC00000579	2	+	36	18	-304.0	-304.0	-304.0
chrX	11762997	11763779	11762922	11763852	JUNC00000581	146	+	75	73	-304.0	-304.0	-304.0
chrX	11763882	11765466	11763834	11765541	JUNC00000582	2	+	48	75	-304.0	-304.0	-304.0
chrX	11763938	11765466	11763863	11765541	JUNC00000580	133	+	75	75	-304.0	-304.0	-304.0
chrX	11765729	11766960	11765672	11766998	JUNC00000584	3	+	57	38	-304.0	-304.0	-304.0
chrX	11765729	11768572	11765654	11768647	JUNC00000583	105	+	75	75	-304.0	-304.0	-304.0
chrX	11768460	11768572	11768405	11768645	JUNC00000585	3	+	55	73	-304.0	-304.0	-304.0
chrX	11768682	11772155	11768608	11772230	JUNC00000586	105	+	74	75	-304.0	-304.0	-304.0
chrX	11772255	11772620	11772181	11772686	JUNC00000587	99	+	74	66	-304.0	-304.0	-304.0
chrX	11772705	11774979	11772631	11775051	JUNC00000588	129	+	74	72	-304.0	-304.0	-304.0
chrX	11793168	11793595	11793119	11793622	JUNC00000589	1	+	49	27	-304.0	-304.0	-304.0
chrX	12559585	12627211	12559541	12627243	JUNC00000590	1	+	44	32	-304.0	-304.0	-304.0
chrX	12743311	12806985	12743280	12807030	JUNC00000591	1	+	31	45	-304.0	-304.0	-304.0
chrX	12755899	12803414	12755867	12803455	JUNC00000592	1	+	32	41	-304.0	-304.0	-304.0
chrX	12791619	12799206	12791545	12799278	JUNC00000593	112	+	74	72	-304.0	-304.0	-304.0
chrX	12792478	12799206	12792418	12799235	JUNC00000594	2	+	60	29	-304.0	-304.0	-304.0
chrX	12799390	12809233	12799316	12809307	JUNC00000595	200	+	74	74	-304.0	-304.0	-304.0
chrX	12799399	12809233	12799325	12809307	JUNC00000596	14	+	74	74	-304.0	-304.0	-304.0
chrX	12809332	12810021	12809257	12810096	JUNC00000597	110	+	75	75	-304.0	-304.0	-304.0
chrX	12810146	12819506	12810071	12819581	JUNC00000598	201	+	75	75	-304.0	-304.0	-304.0
chrX	12819680	12820643	12819605	12820718	JUNC00000599	152	+	75	75	-304.0	-304.0	-304.0
chrX	12820803	12822703	12820728	12822778	JUNC00000600	173	+	75	75	-304.0	-304.0	-304.0
chrX	12822867	12823059	12822831	12823099	JUNC00000601	1	+	36	40	-304.0	-304.0	-304.0
chrX	12867123	12867480	12867049	12867554	JUNC00000602	75	+	74	74	-304.0	-304.0	-304.0
chrX	12867370	12867480	12867330	12867516	JUNC00000603	1	+	40	36	-304.0	-304.0	-304.0
chrX	12867581	12885511	12867506	12885586	JUNC00000604	75	+	75	75	-304.0	-304.0	-304.0
chrX	12971615	12976245	12971541	12976320	JUNC00000605	194	+	74	75	-304.0	-304.0	-304.0
chrX	12975153	12976245	12975119	12976320	JUNC00000607	10	+	34	75	-304.0	-304.0	-304.0
chrX	12975168	12975606	12975121	12975637	JUNC00000608	2	+	47	31	-304.0	-304.0	-304.0
chrX	12975168	12976245	12975094	12976320	JUNC00000606	81390	+	74	75	-304.0	-304.0	-304.0
chrX	12975443	12976245	12975368	12976320	JUNC00000610	321	+	75	75	-304.0	-304.0	-304.0
chrX	12975731	12976245	12975685	12976320	JUNC00000611	307	+	46	75	-304.0	-304.0	-304.0
chrX	12976300	12976333	12976245	12976361	JUNC00000609	9	+	55	28	86.0	-304.0	86.0
chrX	12976361	12976776	12976286	12976851	JUNC00000612	85072	+	75	75	-304.0	-304.0	-304.0
chrX	12976361	12976787	12976286	12976856	JUNC00000614	20	+	75	69	-304.0	-304.0	-304.0
chrX	12976361	12976879	12976286	12976954	JUNC00000613	1715	+	75	75	-304.0	-304.0	-304.0
chrX	12976366	12976774	12976306	12976841	JUNC00000615	15	-	60	67	-304.0	-304.0	-304.0
chrX	12976844	12977070	12976774	12977109	JUNC00000617	2	?	70	39	-304.0	-304.0	-304.0
chrX	12976844	12977070	12976776	12977072	JUNC00000616	3	+	68	2	-304.0	-304.0	-304.0
chrX	12976865	12976945	12976830	12976986	JUNC00000623	1	?	35	41	-304.0	-304.0	-304.0
chrX	12976876	12976925	12976803	12976996	JUNC00000618	9	?	73	71	-304.0	-304.0	-304.0
chrX	12976881	12976916	12976806	12976989	JUNC00000619	75	?	75	73	-304.0	-304.0	-304.0
chrX	12976885	12976911	12976814	12976985	JUNC00000621	4	?	71	74	100.0	100.0	100.0
chrX	12976887	12976957	12976812	12977024	JUNC00000620	3	-	75	67	-304.0	-304.0	-304.0
chrX	12976893	12976959	12976818	12977034	JUNC00000622	4	?	75	75	-304.0	-304.0	-304.0
chrX	12976917	12976940	12976842	12977015	JUNC00000624	24	?	75	75	106.0	106.0	106.0
chrX	12977034	12977076	12976959	12977147	JUNC00000625	578	?	75	71	-304.0	-304.0	-304.0
chrX	12985088	12986650	12985058	12986696	JUNC00000626	1	+	30	46	-304.0	-304.0	-304.0
chrX	12986282	12992190	12986252	12992236	JUNC00000627	1	+	30	46	-304.0	-304.0	-304.0
chrX	12986713	12992190	12986667	12992238	JUNC00000629	2	+	46	48	-304.0	-304.0	-304.0
chrX	12986713	13043209	12986658	13043230	JUNC00000628	1	+	55	21	-304.0	-304.0	-304.0
chrX	13085803	13090994	13085784	13091051	JUNC00000630	1	+	19	57	-304.0	-304.0	-304.0
chrX	13250974	13251186	13250935	13251223	JUNC00000631	1	-	39	37	-304.0	-304.0	-304.0
chrX	13253658	13254420	13253640	13254478	JUNC00000632	1	+	18	58	-304.0	-304.0	-304.0
chrX	13263819	13265458	13263788	13265503	JUNC00000633	1	+	31	45	-304.0	-304.0	-304.0
chrX	13267335	13303319	13267305	13303365	JUNC00000634	1	-	30	46	-304.0	-304.0	-304.0
chrX	13327651	13327757	13327597	13327806	JUNC00000635	2	+	54	49	-304.0	-304.0	-304.0
chrX	13336460	13337894	13336441	13337951	JUNC00000636	1	+	19	57	-304.0	-304.0	-304.0
chrX	13387817	13415329	13387755	13415351	JUNC00000637	2	-	62	22	-304.0	-304.0	-304.0
chrX	13387817	13419568	13387772	13419599	JUNC00000638	1	-	45	31	-304.0	-304.0	-304.0
chrX	13387817	13423298	13387778	13423335	JUNC00000639	1	-	39	37	-304.0	-304.0	-304.0
chrX	13659768	13662500	13659726	13662537	JUNC00000640	2	+	42	37	-304.0	-304.0	-304.0
chrX	13661122	13662500	13661052	13662539	JUNC00000641	4	+	70	39	-304.0	-304.0	-304.0
chrX	13666470	13668235	13666412	13668253	JUNC00000642	1	+	58	18	-304.0	-304.0	-304.0
chrX	13673358	13754498	13673334	13754544	JUNC00000643	1	-	24	46	-304.0	-304.0	-304.0
chrX	13689288	13703734	13689231	13703763	JUNC00000647	2	+	57	29	-304.0	-304.0	-304.0
chrX	13689288	13703788	13689215	13703806	JUNC00000645	2	+	73	18	-304.0	-304.0	-304.0
chrX	13689288	13703813	13689215	13703888	JUNC00000644	139	+	73	75	-304.0	-304.0	-304.0
chrX	13689288	13708720	13689217	13708795	JUNC00000646	16	+	71	75	-304.0	-304.0	-304.0
chrX	13703902	13708720	13703827	13708795	JUNC00000648	180	+	75	75	-304.0	-304.0	-304.0
chrX	13703902	13712947	13703878	13712999	JUNC00000650	1	+	24	52	-304.0	-304.0	-304.0
chrX	13703902	13715719	13703857	13715782	JUNC00000649	2	+	45	63	-304.0	-304.0	-304.0
chrX	13706741	13708720	13706685	13708793	JUNC00000651	2	+	56	73	-304.0	-304.0	-304.0
chrX	13713454	13713812	13713424	13713860	JUNC00000652	2	?	30	48	-304.0	106.0	106.0
chrX	13714505	13716003	13714431	13716077	JUNC00000653	15	-	74	74	-304.0	-304.0	-304.0
chrX	13714505	13716418	13714481	13716470	JUNC00000654	1	-	24	52	-304.0	-304.0	-304.0
chrX	13715395	13717661	13715380	13717721	JUNC00000655	1	-	15	60	-304.0	112.0	112.0
chrX	13715794	13735247	13715737	13735289	JUNC00000656	2	+	57	42	-304.0	-304.0	-304.0
chrX	13716678	13719870	13716607	13719943	JUNC00000657	58	-	71	73	-304.0	-304.0	-304.0
chrX	13719982	13720427	13719935	13720480	JUNC00000660	3	-	47	53	-304.0	-304.0	-304.0
chrX	13719982	13734043	13719919	13734116	JUNC00000659	19	-	63	73	-304.0	-304.0	-304.0
chrX	13719982	13734524	13719909	13734597	JUNC00000658	27	-	73	73	-304.0	-304.0	-304.0
chrX	13720497	13734043	13720427	13734061	JUNC00000661	2	-	70	18	-304.0	-304.0	-304.0
chrX	13720497	13734524	13720439	13734542	JUNC00000662	1	-	58	18	-304.0	-304.0	-304.0
chrX	13734185	13734524	13734115	13734582	JUNC00000663	22	-	70	58	-304.0	-304.0	-304.0
chrX	13735083	13735247	13735031	13735309	JUNC00000664	8	+	52	62	-304.0	-304.0	-304.0
chrX	13735346	13736477	13735272	13736552	JUNC00000665	43	+	74	75	-304.0	-304.0	-304.0
chrX	13736296	13736477	13736238	13736552	JUNC00000666	7	+	58	75	-304.0	-304.0	-304.0
chrX	13736678	13738845	13736604	13738916	JUNC00000667	43	+	74	71	-304.0	-304.0	-304.0
chrX	13738914	13739001	13738842	13739032	JUNC00000668	32	+	72	31	-304.0	-304.0	-304.0
chrX	13739032	13740088	13739001	13740133	JUNC00000670	1	+	31	45	-304.0	-304.0	-304.0
chrX	13739032	13744414	13739000	13744488	JUNC00000669	27	+	32	74	-304.0	-304.0	-304.0
chrX	13744519	13746318	13744452	13746388	JUNC00000671	21	+	67	70	-304.0	-304.0	-304.0
chrX	13746455	13746779	13746384	13746854	JUNC00000672	50	+	71	75	-304.0	-304.0	-304.0
chrX	13746953	13749426	13746881	13749499	JUNC00000673	56	+	72	73	-304.0	-304.0	-304.0
chrX	13746956	13749426	13746936	13749482	JUNC00000674	1	+	20	56	-304.0	-304.0	-304.0
chrX	13749533	13751248	13749459	13751322	JUNC00000675	48	+	74	74	-304.0	-304.0	-304.0
chrX	13749533	13753367	13749459	13753441	JUNC00000676	28	+	74	74	-304.0	-304.0	-304.0
chrX	13751368	13752703	13751312	13752757	JUNC00000678	5	+	56	54	-304.0	-304.0	-304.0
chrX	13751368	13753367	13751298	13753441	JUNC00000677	35	+	70	74	-304.0	-304.0	-304.0
chrX	13751368	13755150	13751340	13755198	JUNC00000679	1	+	28	48	-304.0	-304.0	-304.0
chrX	13753441	13755150	13753368	13755225	JUNC00000680	58	+	73	75	-304.0	-304.0	-304.0
chrX	13753441	13755156	13753399	13755229	JUNC00000681	6	+	42	73	-304.0	-304.0	-304.0
chrX	13755242	13756577	13755167	13756652	JUNC00000682	68	+	75	75	-304.0	-304.0	-304.0
chrX	13756767	13757659	13756692	13757730	JUNC00000683	67	+	75	71	-304.0	-304.0	-304.0
chrX	13757790	13758336	13757716	13758408	JUNC00000684	70	+	74	72	-304.0	-304.0	-304.0
chrX	13758448	13760114	13758374	13760189	JUNC00000685	60	+	74	75	-304.0	-304.0	-304.0
chrX	13760720	13761084	13760645	13761158	JUNC00000686	76	+	75	74	-304.0	-304.0	-304.0
chrX	13761211	13762343	13761136	13762418	JUNC00000687	87	+	75	75	-304.0	-304.0	-304.0
chrX	13762444	13763744	13762370	13763816	JUNC00000688	55	+	74	72	-304.0	-304.0	-304.0
chrX	13762444	13767126	13762371	13767199	JUNC00000689	29	+	73	73	-304.0	-304.0	-304.0
chrX	13762444	13768053	13762401	13768086	JUNC00000690	1	+	43	33	-304.0	-304.0	-304.0
chrX	13763855	13767126	13763780	13767201	JUNC00000691	85	+	75	75	-304.0	-304.0	-304.0
chrX	13767284	13768053	13767209	13768124	JUNC00000693	76	+	75	71	-304.0	-304.0	-304.0
chrX	13767284	13768056	13767209	13768124	JUNC00000692	11	+	75	68	-304.0	-304.0	-304.0
chrX	13767336	13768053	13767278	13768095	JUNC00000694	2	+	58	42	-304.0	-304.0	-304.0
chrX	13768224	13768717	13768150	13768785	JUNC00000695	89	+	74	68	-304.0	-304.0	-304.0
chrX	13768785	13769065	13768715	13769137	JUNC00000696	70	+	70	72	-304.0	-304.0	-304.0
chrX	13768785	13769684	13768723	13769747	JUNC00000697	5	+	62	63	-304.0	-304.0	-304.0
chrX	13792798	13853385	13792775	13853438	JUNC00000698	1	-	23	53	-304.0	-304.0	-304.0
chrX	13935419	14016748	13935394	14016788	JUNC00000699	1	+	25	40	-304.0	-304.0	-304.0
chrX	14002237	14003239	14002174	14003272	JUNC00000700	3	-	63	33	-304.0	-304.0	-304.0
chrX	14007870	14008870	14007801	14008941	JUNC00000701	4	-	69	71	-304.0	-304.0	-304.0
chrX	14007870	14008898	14007838	14008952	JUNC00000702	2	-	32	54	-304.0	-304.0	-304.0
chrX	14009169	14020077	14009094	14020152	JUNC00000703	72	-	75	75	-304.0	-304.0	-304.0
chrX	14020297	14020388	14020247	14020414	JUNC00000704	1	-	50	26	-304.0	-304.0	-304.0
chrX	14020358	14021463	14020309	14021490	JUNC00000705	1	-	49	27	-304.0	-304.0	-304.0
chrX	14020534	14021463	14020465	14021513	JUNC00000706	73	-	69	50	-304.0	-304.0	-304.0
chrX	14021511	14026139	14021463	14026209	JUNC00000707	39	-	48	70	-304.0	-304.0	-304.0
chrX	14021511	14029776	14021463	14029848	JUNC00000708	15	-	48	72	-304.0	-304.0	-304.0
chrX	14026221	14029776	14026146	14029824	JUNC00000709	14	-	75	48	-304.0	-304.0	-304.0
chrX	14692374	14710945	14692329	14710971	JUNC00000710	1	-	45	26	-304.0	-304.0	-304.0
chrX	14797298	14843659	14797270	14843707	JUNC00000711	1	-	28	48	-304.0	-304.0	-304.0
chrX	14843981	14844502	14843906	14844575	JUNC00000712	6	-	75	73	-304.0	-304.0	-304.0
chrX	14844740	14844855	14844709	14844903	JUNC00000713	2	-	31	48	-304.0	-304.0	-304.0
chrX	14844740	14850504	14844720	14850560	JUNC00000714	1	-	20	56	-304.0	-304.0	-304.0
chrX	14845286	14850504	14845223	14850579	JUNC00000715	10	-	63	75	-304.0	-304.0	-304.0
chrX	14850674	14853038	14850617	14853111	JUNC00000716	5	-	57	73	-304.0	-304.0	-304.0
chrX	14853167	14857861	14853097	14857908	JUNC00000717	6	-	70	47	-304.0	-304.0	-304.0
chrX	14857954	14859181	14857895	14859250	JUNC00000718	6	-	59	69	-304.0	-304.0	-304.0
chrX	14859334	14864559	14859265	14864629	JUNC00000719	5	-	69	70	-304.0	-304.0	-304.0
chrX	14865580	14868922	14865514	14868997	JUNC00000720	18	-	66	75	-304.0	-304.0	-304.0
chrX	14865580	14869111	14865528	14869135	JUNC00000721	1	-	52	24	-304.0	-304.0	-304.0
chrX	14865580	14872985	14865549	14873029	JUNC00000722	1	-	31	44	-304.0	-304.0	-304.0
chrX	14869043	14872985	14868972	14873038	JUNC00000723	12	-	71	53	-304.0	-304.0	-304.0
chrX	14869043	14873006	14869007	14873046	JUNC00000724	1	-	36	40	-304.0	-304.0	-304.0
chrX	14873537	14873688	14873468	14873759	JUNC00000725	39	+	69	71	-304.0	-304.0	-304.0
chrX	14873758	14892722	14873687	14892794	JUNC00000726	26	+	71	72	-304.0	-304.0	-304.0
chrX	14892878	14895307	14892813	14895375	JUNC00000727	19	+	65	68	-304.0	-304.0	-304.0
chrX	14895394	14897083	14895320	14897157	JUNC00000728	24	+	74	74	-304.0	-304.0	-304.0
chrX	14897238	14900574	14897167	14900635	JUNC00000729	31	+	71	61	-304.0	-304.0	-304.0
chrX	14900635	14902965	14900574	14903004	JUNC00000730	25	+	61	39	-304.0	-304.0	-304.0
chrX	14903004	14908859	14902965	14908930	JUNC00000731	28	+	39	71	-304.0	-304.0	-304.0
chrX	14908984	14911236	14908909	14911305	JUNC00000732	28	+	75	69	-304.0	-304.0	-304.0
chrX	14911413	14912248	14911339	14912323	JUNC00000733	21	+	74	75	-304.0	-304.0	-304.0
chrX	14912361	14914502	14912286	14914577	JUNC00000734	23	+	75	75	-304.0	-304.0	-304.0
chrX	14914599	14915667	14914524	14915739	JUNC00000735	24	+	75	72	-304.0	-304.0	-304.0
chrX	14914599	14916196	14914564	14916234	JUNC00000736	1	+	35	38	-304.0	-304.0	-304.0
chrX	14915764	14916196	14915704	14916269	JUNC00000737	19	+	60	73	-304.0	-304.0	-304.0
chrX	14916326	14918679	14916256	14918754	JUNC00000738	34	+	70	75	-304.0	-304.0	-304.0
chrX	14918782	14919671	14918709	14919743	JUNC00000739	29	+	73	72	-304.0	-304.0	-304.0
chrX	15151567	15182971	15151531	15183011	JUNC00000741	1	-	36	40	-304.0	-304.0	-304.0
chrX	15151567	15185446	15151509	15185464	JUNC00000740	1	-	58	18	-304.0	-304.0	-304.0
chrX	15185537	15198770	15185518	15198828	JUNC00000742	2	-	19	58	-304.0	-304.0	-304.0
chrX	15248935	15250429	15248878	15250463	JUNC00000743	3	-	57	34	-304.0	-304.0	-304.0
chrX	15250564	15252253	15250508	15252309	JUNC00000744	2	-	56	56	-304.0	-304.0	-304.0
chrX	15254844	15258865	15254791	15258938	JUNC00000745	4	-	53	73	-304.0	-304.0	-304.0
chrX	15258945	15269780	15258905	15269830	JUNC00000746	2	-	40	50	-304.0	-304.0	-304.0
chrX	15321772	15324664	15321699	15324729	JUNC00000747	23	-	73	65	-304.0	-304.0	-304.0
chrX	15324871	15325019	15324802	15325091	JUNC00000748	15	-	69	72	-304.0	-304.0	-304.0
chrX	15325152	15325913	15325079	15325988	JUNC00000749	20	-	73	75	-304.0	-304.0	-304.0
chrX	15326046	15331215	15325971	15331289	JUNC00000750	13	-	75	74	-304.0	-304.0	-304.0
chrX	15326046	15331589	15325971	15331655	JUNC00000753	4	-	75	66	-304.0	-304.0	-304.0
chrX	15326046	15331873	15325971	15331903	JUNC00000752	3	-	75	30	-304.0	-304.0	-304.0
chrX	15326046	15335500	15325971	15335527	JUNC00000751	2	-	75	27	-304.0	-304.0	-304.0
chrX	15331992	15335500	15331918	15335536	JUNC00000754	14	-	74	36	-304.0	-304.0	-304.0
chrX	15346259	15347163	15346217	15347197	JUNC00000755	1	-	42	34	-304.0	-304.0	-304.0
chrX	15353095	15355149	15353075	15355205	JUNC00000756	1	-	20	56	-304.0	-304.0	-304.0
chrX	15355298	15358002	15355238	15358061	JUNC00000757	4	-	60	59	-304.0	-304.0	-304.0
chrX	15385116	15389268	15385064	15389291	JUNC00000759	1	-	52	23	-304.0	-304.0	-304.0
chrX	15385116	15390184	15385045	15390251	JUNC00000758	63	-	71	67	-304.0	-304.0	-304.0
chrX	15385145	15390184	15385099	15390214	JUNC00000760	1	-	46	30	-304.0	-304.0	-304.0
chrX	15390251	15397448	15390182	15397523	JUNC00000761	91	-	69	75	-304.0	-304.0	-304.0
chrX	15397531	15407505	15397461	15407551	JUNC00000762	99	-	70	46	-304.0	-304.0	-304.0
chrX	15407550	15408536	15407524	15408586	JUNC00000765	1	-	26	50	-304.0	-304.0	-304.0
chrX	15407550	15425905	15407504	15425979	JUNC00000763	95	-	46	74	-304.0	-304.0	-304.0
chrX	15407550	15455847	15407505	15455905	JUNC00000764	2	-	45	58	-304.0	-304.0	-304.0
chrX	15425990	15455847	15425915	15455920	JUNC00000766	79	-	75	73	-304.0	-304.0	-304.0
chrX	15429596	15461520	15429579	15461579	JUNC00000767	1	-	17	59	-304.0	-304.0	-304.0
chrX	15456054	15459656	15455979	15459729	JUNC00000768	44	-	75	73	-304.0	-304.0	-304.0
chrX	15456054	15479728	15455993	15479764	JUNC00000769	3	-	61	36	-304.0	-304.0	-304.0
chrX	15459740	15479728	15459666	15479802	JUNC00000770	55	-	74	74	-304.0	-304.0	-304.0
chrX	15479821	15491161	15479747	15491235	JUNC00000771	46	-	74	74	-304.0	-304.0	-304.0
chrX	15491309	15493155	15491279	15493206	JUNC00000773	2	-	30	51	-304.0	-304.0	-304.0
chrX	15491309	15493189	15491234	15493262	JUNC00000772	18	-	75	73	-304.0	-304.0	-304.0
chrX	15628127	15639561	15628073	15639612	JUNC00000774	2	-	54	51	-304.0	-304.0	-304.0
chrX	15659101	15664336	15659051	15664385	JUNC00000775	2	-	50	49	-304.0	-304.0	-304.0
chrX	15674956	15675689	15674933	15675742	JUNC00000776	1	+	23	53	-304.0	-304.0	-304.0
chrX	15675778	15681000	15675748	15681046	JUNC00000778	1	+	30	46	-304.0	-304.0	-304.0
chrX	15675778	15688660	15675703	15688728	JUNC00000777	56	+	75	68	-304.0	-304.0	-304.0
chrX	15688858	15691137	15688814	15691169	JUNC00000783	1	+	44	32	-304.0	-304.0	-304.0
chrX	15688858	15692962	15688789	15693037	JUNC00000779	31	+	69	75	-304.0	-304.0	-304.0
chrX	15688858	15697239	15688806	15697312	JUNC00000781	4	+	52	73	-304.0	-304.0	-304.0
chrX	15688858	15702781	15688807	15702828	JUNC00000782	3	+	51	47	-304.0	-304.0	-304.0
chrX	15688858	15721496	15688805	15721519	JUNC00000780	1	+	53	23	-304.0	-304.0	-304.0
chrX	15690827	15690863	15690784	15690896	JUNC00000784	1	-	43	33	-304.0	-304.0	-304.0
chrX	15691241	15774301	15691188	15774324	JUNC00000785	1	+	53	23	-304.0	-304.0	-304.0
chrX	15693058	15697239	15692994	15697305	JUNC00000786	6	+	64	66	-304.0	-304.0	-304.0
chrX	15693058	15702426	15693026	15702470	JUNC00000789	1	+	32	44	-304.0	-304.0	-304.0
chrX	15693058	15702781	15692998	15702853	JUNC00000787	7	+	60	72	-304.0	-304.0	-304.0
chrX	15693058	15721496	15693017	15721531	JUNC00000788	1	+	41	35	-304.0	-304.0	-304.0
chrX	15697765	15702781	15697724	15702854	JUNC00000790	3	+	41	73	-304.0	-304.0	-304.0
chrX	15721592	15749970	15721546	15750000	JUNC00000791	1	+	46	30	-304.0	-304.0	-304.0
chrX	15738352	15745630	15738314	15745668	JUNC00000793	1	+	38	38	-304.0	-304.0	-304.0
chrX	15738352	15749970	15738294	15750027	JUNC00000792	4	+	58	57	-304.0	-304.0	-304.0
chrX	15750165	15764577	15750091	15764651	JUNC00000794	6	+	74	74	-304.0	-304.0	-304.0
chrX	15764775	15772495	15764703	15772568	JUNC00000795	8	+	72	73	-304.0	-304.0	-304.0
chrX	15772614	15774301	15772555	15774365	JUNC00000796	9	+	59	64	-304.0	-304.0	-304.0
chrX	15774397	15775245	15774327	15775308	JUNC00000797	15	+	70	63	-304.0	-304.0	-304.0
chrX	15775308	15776713	15775244	15776768	JUNC00000798	14	+	64	55	-304.0	-304.0	-304.0
chrX	15776869	15781004	15776831	15781042	JUNC00000800	1	+	38	38	-304.0	-304.0	-304.0
chrX	15776869	15782484	15776801	15782547	JUNC00000799	8	+	68	63	-304.0	-304.0	-304.0
chrX	15790536	15790933	15790481	15790997	JUNC00000801	28	+	55	64	-304.0	-304.0	-304.0
chrX	15791013	15799871	15790938	15799944	JUNC00000802	48	+	75	73	-304.0	-304.0	-304.0
chrX	15791013	15799882	15790974	15799953	JUNC00000803	4	+	39	71	-304.0	-304.0	-304.0
chrX	15796250	15799871	15796178	15799940	JUNC00000805	7	+	72	69	-304.0	-304.0	-304.0
chrX	15799953	15801250	15799912	15801284	JUNC00000807	1	+	41	34	-304.0	-304.0	-304.0
chrX	15799953	15801273	15799878	15801329	JUNC00000806	2	+	75	56	-304.0	-304.0	-304.0
chrX	15799953	15803687	15799878	15803753	JUNC00000804	50	+	75	66	-304.0	-304.0	-304.0
chrX	15803796	15804110	15803722	15804185	JUNC00000808	55	+	74	75	-304.0	-304.0	-304.0
chrX	15804197	15808232	15804125	15808271	JUNC00000809	57	+	72	39	-304.0	-304.0	-304.0
chrX	15808271	15809199	15808209	15809270	JUNC00000810	50	+	62	71	-304.0	-304.0	-304.0
chrX	15809318	15815676	15809243	15815749	JUNC00000811	22	+	75	73	-304.0	-304.0	-304.0
chrX	15815890	15818586	15815819	15818642	JUNC00000812	27	+	71	56	-304.0	-304.0	-304.0
chrX	15818642	15820206	15818586	15820272	JUNC00000813	29	+	56	66	-304.0	-304.0	-304.0
chrX	15820316	15822730	15820244	15822805	JUNC00000814	31	+	72	75	-304.0	-304.0	-304.0
chrX	15820316	15822844	15820247	15822903	JUNC00000815	2	+	69	59	-304.0	-304.0	-304.0
chrX	15827372	15845378	15827297	15845453	JUNC00000816	248	-	75	75	-304.0	-304.0	-304.0
chrX	15831568	15833443	15831496	15833492	JUNC00000818	6	-	72	49	-304.0	-304.0	-304.0
chrX	15831568	15845378	15831496	15845445	JUNC00000817	8	-	72	67	-304.0	-304.0	-304.0
chrX	15833007	15833443	15832936	15833514	JUNC00000820	6	-	71	71	-304.0	-304.0	-304.0
chrX	15833007	15845378	15832933	15845447	JUNC00000819	11	-	74	69	-304.0	-304.0	-304.0
chrX	15833524	15845378	15833453	15845414	JUNC00000821	4	-	71	36	-304.0	-304.0	-304.0
chrX	15845516	15845902	15845441	15845977	JUNC00000822	53	-	75	75	-304.0	-304.0	-304.0
chrX	15846011	15852345	15845939	15852419	JUNC00000823	44	-	72	74	-304.0	-304.0	-304.0
chrX	15852524	15854687	15852453	15854720	JUNC00000824	11	-	71	33	-304.0	-304.0	-304.0
chrX	15854539	16008599	15854524	16008660	JUNC00000825	1	+	15	61	-304.0	-304.0	-304.0
chrX	15954993	16008599	15954968	16008650	JUNC00000826	1	+	25	51	-304.0	-304.0	-304.0
chrX	16066293	16098458	16066275	16098516	JUNC00000827	1	-	18	58	-304.0	-304.0	-304.0
chrX	16119244	16119461	16119226	16119518	JUNC00000828	1	-	18	57	-304.0	-304.0	-304.0
chrX	16150656	16152255	16150592	16152321	JUNC00000829	7	+	64	66	-304.0	-304.0	-304.0
chrX	16557260	16557433	16557212	16557461	JUNC00000830	1	+	48	28	-304.0	-304.0	-304.0
chrX	16580409	16609540	16580370	16609577	JUNC00000831	1	-	39	37	-304.0	-304.0	-304.0
chrX	16589775	16590751	16589700	16590826	JUNC00000832	42	-	75	75	-304.0	-304.0	-304.0
chrX	16589775	16609540	16589728	16609569	JUNC00000833	1	-	47	29	-304.0	-304.0	-304.0
chrX	16590862	16609540	16590789	16609612	JUNC00000834	48	-	73	72	-304.0	-304.0	-304.0
chrX	16609685	16617149	16609614	16617219	JUNC00000835	26	-	71	70	-304.0	-304.0	-304.0
chrX	16617246	16620276	16617171	16620332	JUNC00000836	27	-	75	56	-304.0	-304.0	-304.0
chrX	16620332	16639146	16620273	16639218	JUNC00000837	29	-	59	72	-304.0	-304.0	-304.0
chrX	16638961	16639146	16638942	16639203	JUNC00000838	1	-	19	57	-304.0	-304.0	-304.0
chrX	16639243	16653205	16639207	16653245	JUNC00000840	1	-	36	40	-304.0	-304.0	-304.0
chrX	16639243	16667513	16639169	16667559	JUNC00000839	54	-	74	46	-304.0	-304.0	-304.0
chrX	16667557	16667661	16667513	16667724	JUNC00000841	43	-	44	63	-304.0	-304.0	-304.0
chrX	16667724	16670579	16667661	16670654	JUNC00000842	59	-	63	75	-304.0	-304.0	-304.0
chrX	16670674	16678361	16670599	16678430	JUNC00000843	69	-	75	69	-304.0	-304.0	-304.0
chrX	16670674	16683093	16670639	16683134	JUNC00000844	1	-	35	41	-304.0	-304.0	-304.0
chrX	16674623	16693950	16674589	16693992	JUNC00000845	1	+	34	42	-304.0	-304.0	-304.0
chrX	16675034	16725415	16674998	16725455	JUNC00000846	1	+	36	40	-304.0	-304.0	-304.0
chrX	16678450	16683093	16678375	16683165	JUNC00000847	62	-	75	72	-304.0	-304.0	-304.0
chrX	16683226	16689449	16683157	16689520	JUNC00000848	26	-	69	71	-304.0	-304.0	-304.0
chrX	16689601	16691539	16689528	16691613	JUNC00000849	26	-	73	74	-304.0	-304.0	-304.0
chrX	16691620	16693140	16691546	16693213	JUNC00000850	48	-	74	73	-304.0	-304.0	-304.0
chrX	16693224	16693370	16693153	16693445	JUNC00000851	59	-	71	75	-304.0	-304.0	-304.0
chrX	16693487	16693664	16693412	16693704	JUNC00000852	5	-	75	40	-304.0	-304.0	-304.0
chrX	16698336	16698922	16698262	16698997	JUNC00000853	35	-	74	75	-304.0	-304.0	-304.0
chrX	16699093	16702736	16699026	16702806	JUNC00000854	35	-	67	70	-304.0	-304.0	-304.0
chrX	16700554	16702736	16700529	16702787	JUNC00000855	1	-	25	51	-304.0	-304.0	-304.0
chrX	16702941	16712334	16702875	16712392	JUNC00000857	12	-	66	58	-304.0	-304.0	-304.0
chrX	16702941	16712412	16702888	16712435	JUNC00000859	1	-	53	23	-304.0	-304.0	-304.0
chrX	16702941	16712557	16702874	16712628	JUNC00000856	5	-	67	71	-304.0	-304.0	-304.0
chrX	16702941	16712721	16702884	16712772	JUNC00000858	4	-	57	51	-304.0	-304.0	-304.0
chrX	16704169	16812239	16704143	16812288	JUNC00000860	1	-	26	49	-304.0	-304.0	-304.0
chrX	16708518	16712334	16708466	16712373	JUNC00000861	2	-	52	39	-304.0	-304.0	-304.0
chrX	16719899	16735226	16719836	16735300	JUNC00000863	88	+	63	74	-304.0	-304.0	-304.0
chrX	16719899	16735264	16719828	16735307	JUNC00000862	6	+	71	43	-304.0	-304.0	-304.0
chrX	16735345	16736165	16735271	16736232	JUNC00000864	178	+	74	67	-304.0	-304.0	-304.0
chrX	16736232	16741715	16736163	16741790	JUNC00000865	154	+	69	75	-304.0	-304.0	-304.0
chrX	16741789	16743700	16741714	16743775	JUNC00000866	145	+	75	75	-304.0	-304.0	-304.0
chrX	16743840	16754944	16743765	16755019	JUNC00000867	160	+	75	75	-304.0	-304.0	-304.0
chrX	16755093	16756662	16755018	16756722	JUNC00000868	136	+	75	60	-304.0	-304.0	-304.0
chrX	16755093	16756668	16755049	16756721	JUNC00000869	5	+	44	53	-304.0	-304.0	-304.0
chrX	16756721	16757161	16756660	16757236	JUNC00000870	152	+	61	75	-304.0	-304.0	-304.0
chrX	16757309	16760231	16757234	16760306	JUNC00000871	177	+	75	75	-304.0	-304.0	-304.0
chrX	16786589	16793676	16786567	16793730	JUNC00000873	1	+	22	54	-304.0	-304.0	-304.0
chrX	16786589	16818573	16786561	16818648	JUNC00000872	10	+	28	75	-304.0	-304.0	-304.0
chrX	16811919	16818573	16811888	16818618	JUNC00000874	1	+	31	45	-304.0	-304.0	-304.0
chrX	16818877	16820163	16818805	16820227	JUNC00000875	18	+	72	64	-304.0	-304.0	-304.0
chrX	16820255	16828093	16820190	16828163	JUNC00000876	18	+	65	70	-304.0	-304.0	-304.0
chrX	16828264	16829575	16828189	16829646	JUNC00000877	49	+	75	71	-304.0	-304.0	-304.0
chrX	16829770	16832622	16829696	16832693	JUNC00000878	49	+	74	71	-304.0	-304.0	-304.0
chrX	16832742	16834282	16832673	16834357	JUNC00000879	45	+	69	75	-304.0	-304.0	-304.0
chrX	16834357	16837592	16834286	16837656	JUNC00000880	31	+	71	64	-304.0	-304.0	-304.0
chrX	16837685	16839820	16837614	16839893	JUNC00000881	52	+	71	73	-304.0	-304.0	-304.0
chrX	16839916	16840444	16839879	16840483	JUNC00000883	1	+	37	39	-304.0	-304.0	-304.0
chrX	16839916	16841427	16839845	16841502	JUNC00000882	51	+	71	75	-304.0	-304.0	-304.0
chrX	16840825	16841427	16840776	16841492	JUNC00000884	3	+	49	65	-304.0	-304.0	-304.0
chrX	16845103	16845827	16845028	16845902	JUNC00000885	374	-	75	75	-304.0	-304.0	-304.0
chrX	16845938	16849243	16845863	16849303	JUNC00000886	377	-	75	60	-304.0	-304.0	-304.0
chrX	16849301	16852045	16849243	16852120	JUNC00000887	425	-	58	75	-304.0	-304.0	-304.0
chrX	16849301	16869075	16849259	16869109	JUNC00000888	1	-	42	34	-304.0	-304.0	-304.0
chrX	16852122	16852415	16852056	16852487	JUNC00000890	12	-	66	72	-304.0	-304.0	-304.0
chrX	16852122	16852550	16852051	16852625	JUNC00000889	254	-	71	75	-304.0	-304.0	-304.0
chrX	16852517	16852748	16852497	16852804	JUNC00000891	1	-	20	56	-304.0	-304.0	-304.0
chrX	16852550	16852748	16852503	16852808	JUNC00000892	5	-	47	60	-304.0	-304.0	-304.0
chrX	16852628	16852748	16852553	16852821	JUNC00000893	297	-	75	73	-304.0	-304.0	-304.0
chrX	16852628	16853681	16852588	16853754	JUNC00000894	2	-	40	73	-304.0	-304.0	-304.0
chrX	16852875	16853681	16852800	16853755	JUNC00000895	328	-	75	74	-304.0	-304.0	-304.0
chrX	16853842	16857593	16853767	16857667	JUNC00000896	552	-	75	74	-304.0	-304.0	-304.0
chrX	16857709	16858675	16857635	16858750	JUNC00000897	523	-	74	75	-304.0	-304.0	-304.0
chrX	16858822	16862954	16858747	16863021	JUNC00000898	18	-	75	67	-304.0	-304.0	-304.0
chrX	16858849	16862954	16858774	16863029	JUNC00000899	443	-	75	75	-304.0	-304.0	-304.0
chrX	16863100	16869075	16863025	16869150	JUNC00000900	370	-	75	75	-304.0	-304.0	-304.0
chrX	16863100	16870037	16863051	16870090	JUNC00000901	2	-	49	53	-304.0	-304.0	-304.0
chrX	16869220	16869493	16869148	16869564	JUNC00000904	26	-	72	71	-304.0	-304.0	-304.0
chrX	16869220	16870037	16869145	16870112	JUNC00000902	216	-	75	75	-304.0	-304.0	-304.0
chrX	16869220	16870046	16869145	16870064	JUNC00000903	5	-	75	18	-304.0	-304.0	-304.0
chrX	16970278	17034378	16970242	17034418	JUNC00000905	1	-	36	40	-304.0	-304.0	-304.0
chrX	17047482	17052381	17047448	17052423	JUNC00000906	1	+	34	42	-304.0	-304.0	-304.0
chrX	17054950	17062437	17054898	17062488	JUNC00000907	2	+	52	51	-304.0	-304.0	-304.0
chrX	17133907	17135260	17133866	17135295	JUNC00000908	1	+	41	35	-304.0	-304.0	-304.0
chrX	17135406	17138855	17135354	17138877	JUNC00000909	1	+	52	22	-304.0	-304.0	-304.0
chrX	17138961	17147412	17138908	17147435	JUNC00000910	1	+	53	23	-304.0	-304.0	-304.0
chrX	17737680	17744070	17737653	17744119	JUNC00000912	1	+	27	49	-304.0	-304.0	-304.0
chrX	17737680	17746017	17737625	17746064	JUNC00000911	3	+	55	47	-304.0	-304.0	-304.0
chrX	17744219	17745455	17744179	17745491	JUNC00000913	1	+	40	36	-304.0	-304.0	-304.0
chrX	17746098	17749399	17746045	17749463	JUNC00000914	9	+	53	64	-304.0	-304.0	-304.0
chrX	17749504	17749893	17749435	17749968	JUNC00000915	13	+	69	75	-304.0	-304.0	-304.0
chrX	17750293	17751814	17750219	17751883	JUNC00000916	16	+	74	69	-304.0	-304.0	-304.0
chrX	17751966	17753257	17751891	17753323	JUNC00000917	17	+	75	66	-304.0	-304.0	-304.0
chrX	18257030	18258043	18256991	18258080	JUNC00000918	1	-	39	37	-304.0	-304.0	-304.0
chrX	18260291	18265584	18260289	18265658	JUNC00000919	1	-	2	74	-304.0	-304.0	-304.0
chrX	18305215	18320331	18305191	18320400	JUNC00000920	2	-	24	69	-304.0	-304.0	-304.0
chrX	18375309	18438559	18375273	18438595	JUNC00000921	1	+	36	36	-304.0	-304.0	-304.0
chrX	18425695	18506934	18425664	18506978	JUNC00000922	1	+	31	44	-304.0	-304.0	-304.0
chrX	18507160	18510819	18507127	18510855	JUNC00000923	1	+	33	36	-304.0	-304.0	-304.0
chrX	18507160	18564476	18507131	18564522	JUNC00000924	2	+	29	46	-304.0	-304.0	-304.0
chrX	18522877	18526865	18522861	18526919	JUNC00000926	1	-	16	54	-304.0	-304.0	-304.0
chrX	18564522	18575353	18564476	18575428	JUNC00000925	4	+	46	75	-304.0	-304.0	-304.0
chrX	18575490	18579847	18575436	18579910	JUNC00000927	4	+	54	63	-304.0	-304.0	-304.0
chrX	18579968	18581890	18579899	18581941	JUNC00000928	4	+	69	51	-304.0	-304.0	-304.0
chrX	18581950	18584262	18581891	18584337	JUNC00000929	5	+	59	75	-304.0	-304.0	-304.0
chrX	18584353	18587953	18584315	18587988	JUNC00000930	1	+	38	35	-304.0	-304.0	-304.0
chrX	18595428	18598461	18595395	18598504	JUNC00000931	1	+	33	43	-304.0	-304.0	-304.0
chrX	18598562	18603901	18598495	18603928	JUNC00000932	2	+	67	27	-304.0	-304.0	-304.0
chrX	18598613	18603901	18598544	18603950	JUNC00000933	3	+	69	49	-304.0	-304.0	-304.0
chrX	18604868	18608810	18604818	18608846	JUNC00000934	3	+	50	36	-304.0	-304.0	-304.0
chrX	18608912	18609464	18608844	18609513	JUNC00000935	4	+	68	49	-304.0	-304.0	-304.0
chrX	18609570	18613151	18609542	18613199	JUNC00000936	1	+	28	48	-304.0	-304.0	-304.0
chrX	18613275	18619866	18613204	18619922	JUNC00000937	4	+	71	56	-304.0	-304.0	-304.0
chrX	18619966	18625127	18619920	18625157	JUNC00000938	1	+	46	30	-304.0	-304.0	-304.0
chrX	18625247	18628370	18625190	18628440	JUNC00000939	4	+	57	70	-304.0	-304.0	-304.0
chrX	18703187	18707658	18703138	18707685	JUNC00000940	1	+	49	27	-304.0	-304.0	-304.0
chrX	18707059	18756410	18707019	18756446	JUNC00000941	1	-	40	36	-304.0	-304.0	-304.0
chrX	18709728	18756410	18709688	18756446	JUNC00000942	1	-	40	36	-304.0	-304.0	-304.0
chrX	18726228	19117169	18726192	19117202	JUNC00000943	1	-	36	33	-304.0	-304.0	-304.0
chrX	18730945	18756410	18730905	18756446	JUNC00000944	1	-	40	36	-304.0	-304.0	-304.0
chrX	18776377	18817484	18776351	18817534	JUNC00000945	1	+	26	50	-304.0	-304.0	-304.0
chrX	18804077	18806402	18804045	18806446	JUNC00000946	1	+	32	44	-304.0	-304.0	-304.0
chrX	18807796	18822646	18807775	18822695	JUNC00000947	1	-	21	49	110.0	-304.0	110.0
chrX	18811189	18822646	18811168	18822695	JUNC00000948	1	-	21	49	-304.0	106.0	106.0
chrX	18820522	18822646	18820497	18822697	JUNC00000949	1	-	25	51	122.0	-304.0	122.0
chrX	18850991	18902073	18850967	18902125	JUNC00000950	1	-	24	52	-304.0	-304.0	-304.0
chrX	18854087	18902073	18854063	18902125	JUNC00000951	1	-	24	52	-304.0	-304.0	-304.0
chrX	18887123	18887522	18887090	18887565	JUNC00000952	1	+	33	43	-304.0	-304.0	-304.0
chrX	18890628	18891295	18890576	18891319	JUNC00000953	1	+	52	24	-304.0	-304.0	-304.0
chrX	18891410	18891551	18891389	18891606	JUNC00000954	1	+	21	55	-304.0	-304.0	-304.0
chrX	18892296	18892554	18892252	18892586	JUNC00000955	1	+	44	32	-304.0	-304.0	-304.0
chrX	18893338	18894146	18893267	18894151	JUNC00000956	1	+	71	5	-304.0	-304.0	-304.0
chrX	18893655	18894203	18893583	18894278	JUNC00000957	30	-	72	75	-304.0	-304.0	-304.0
chrX	18894404	18895137	18894330	18895191	JUNC00000959	53	-	74	54	-304.0	-304.0	-304.0
chrX	18894404	18897162	18894330	18897201	JUNC00000958	5	-	74	39	-304.0	-304.0	-304.0
chrX	18895191	18897162	18895125	18897236	JUNC00000960	48	-	66	74	-304.0	-304.0	-304.0
chrX	18897333	18899148	18897317	18899208	JUNC00000966	1	-	16	60	-304.0	-304.0	-304.0
chrX	18897333	18899172	18897258	18899228	JUNC00000962	34	-	75	56	-304.0	-304.0	-304.0
chrX	18897333	18900669	18897258	18900699	JUNC00000963	6	-	75	30	-304.0	-304.0	-304.0
chrX	18897333	18901484	18897258	18901559	JUNC00000961	8	-	75	75	-304.0	-304.0	-304.0
chrX	18899226	18900669	18899171	18900699	JUNC00000965	33	-	55	30	-304.0	-304.0	-304.0
chrX	18900699	18901484	18900669	18901559	JUNC00000964	31	-	30	75	-304.0	-304.0	-304.0
chrX	18901603	18905757	18901537	18905831	JUNC00000967	43	-	66	74	-304.0	-304.0	-304.0
chrX	18902910	18905757	18902860	18905783	JUNC00000968	1	-	50	26	-304.0	-304.0	-304.0
chrX	18905859	18906494	18905784	18906567	JUNC00000969	42	-	75	73	-304.0	-304.0	-304.0
chrX	18906624	18906735	18906550	18906810	JUNC00000970	35	-	74	75	-304.0	-304.0	-304.0
chrX	18906814	18907017	18906739	18907092	JUNC00000971	38	-	75	75	-304.0	-304.0	-304.0
chrX	18907097	18907899	18907022	18907970	JUNC00000972	29	-	75	71	-304.0	-304.0	-304.0
chrX	18908056	18908800	18907983	18908875	JUNC00000973	29	-	73	75	-304.0	-304.0	-304.0
chrX	18908934	18910871	18908859	18910945	JUNC00000974	28	-	75	74	-304.0	-304.0	-304.0
chrX	18910960	18918680	18910886	18918751	JUNC00000975	33	-	74	71	-304.0	-304.0	-304.0
chrX	18918854	18920031	18918779	18920104	JUNC00000976	32	-	75	73	-304.0	-304.0	-304.0
chrX	18920201	18924055	18920128	18924124	JUNC00000977	32	-	73	69	-304.0	-304.0	-304.0
chrX	18924134	18924380	18924060	18924448	JUNC00000978	30	-	74	68	-304.0	-304.0	-304.0
chrX	18924525	18925667	18924458	18925740	JUNC00000979	18	-	67	73	-304.0	-304.0	-304.0
chrX	18925777	18926452	18925705	18926526	JUNC00000980	16	-	72	74	-304.0	-304.0	-304.0
chrX	18926587	18929227	18926514	18929301	JUNC00000981	39	-	73	74	-304.0	-304.0	-304.0
chrX	18929306	18931640	18929234	18931713	JUNC00000982	31	-	72	73	-304.0	-304.0	-304.0
chrX	18931748	18936054	18931679	18936127	JUNC00000983	41	-	69	73	-304.0	-304.0	-304.0
chrX	18936150	18938626	18936077	18938701	JUNC00000984	40	-	73	75	-304.0	-304.0	-304.0
chrX	18936150	18938691	18936107	18938749	JUNC00000985	2	-	43	58	-304.0	-304.0	-304.0
chrX	18938749	18939994	18938677	18940053	JUNC00000986	44	-	72	59	-304.0	-304.0	-304.0
chrX	18940048	18941528	18939994	18941599	JUNC00000987	28	-	54	71	-304.0	-304.0	-304.0
chrX	18941675	18943709	18941606	18943784	JUNC00000988	29	-	69	75	-304.0	-304.0	-304.0
chrX	18941675	18945077	18941635	18945120	JUNC00000989	2	-	40	43	-304.0	-304.0	-304.0
chrX	18943808	18945077	18943733	18945145	JUNC00000990	37	-	75	68	-304.0	-304.0	-304.0
chrX	18945158	18948743	18945084	18948818	JUNC00000991	23	-	74	75	-304.0	-304.0	-304.0
chrX	18948826	18951103	18948762	18951176	JUNC00000992	23	-	64	73	-304.0	-304.0	-304.0
chrX	18948826	18952493	18948788	18952541	JUNC00000993	3	-	38	48	-304.0	-304.0	-304.0
chrX	18951272	18952493	18951199	18952541	JUNC00000995	36	-	73	48	-304.0	-304.0	-304.0
chrX	18952541	18954253	18952492	18954325	JUNC00000994	54	-	49	72	-304.0	-304.0	-304.0
chrX	18954412	18983854	18954337	18983926	JUNC00000996	24	-	75	72	-304.0	-304.0	-304.0
chrX	18996152	18998995	18996094	18999068	JUNC00000997	3	-	58	73	-304.0	-304.0	-304.0
chrX	19003114	19004757	19003079	19004804	JUNC00000998	2	-	35	47	-304.0	-304.0	-304.0
chrX	19004879	19006001	19004823	19006021	JUNC00000999	1	-	56	20	-304.0	-304.0	-304.0
chrX	19009782	19010612	19009728	19010643	JUNC00001000	2	-	54	31	-304.0	-304.0	-304.0
chrX	19014074	19019598	19014028	19019628	JUNC00001001	1	-	46	30	-304.0	-304.0	-304.0
chrX	19019665	19021103	19019622	19021136	JUNC00001002	1	-	43	33	-304.0	-304.0	-304.0
chrX	19023948	19027218	19023908	19027261	JUNC00001003	2	-	40	43	-304.0	-304.0	-304.0
chrX	19028238	19030983	19028206	19031040	JUNC00001004	2	-	32	57	-304.0	-304.0	-304.0
chrX	19035977	19037466	19035941	19037497	JUNC00001005	1	-	36	31	-304.0	-304.0	-304.0
chrX	19201829	19201910	19201801	19201958	JUNC00001006	1	-	28	48	-304.0	-304.0	-304.0
chrX	19344094	19346509	19344027	19346583	JUNC00001008	10	+	67	74	-304.0	-304.0	-304.0
chrX	19344094	19349311	19344019	19349371	JUNC00001007	155	+	75	60	-304.0	-304.0	-304.0
chrX	19345819	19346509	19345762	19346571	JUNC00001010	2	+	57	62	-304.0	-304.0	-304.0
chrX	19345819	19349311	19345768	19349371	JUNC00001011	2	+	51	60	-304.0	-304.0	-304.0
chrX	19346623	19349311	19346561	19349371	JUNC00001012	8	+	62	60	-304.0	-304.0	-304.0
chrX	19349371	19349936	19349311	19350011	JUNC00001009	203	+	60	75	-304.0	-304.0	-304.0
chrX	19350110	19351280	19350035	19351355	JUNC00001013	244	+	75	75	-304.0	-304.0	-304.0
chrX	19351407	19353081	19351332	19353156	JUNC00001014	293	+	75	75	-304.0	-304.0	-304.0
chrX	19353173	19354490	19353098	19354565	JUNC00001015	199	+	75	75	-304.0	-304.0	-304.0
chrX	19353173	19355348	19353098	19355423	JUNC00001016	13	+	75	75	-304.0	-304.0	-304.0
chrX	19354583	19355348	19354510	19355423	JUNC00001017	293	+	73	75	-304.0	-304.0	-304.0
chrX	19355504	19355685	19355429	19355758	JUNC00001018	318	+	75	73	-304.0	-304.0	-304.0
chrX	19355757	19357651	19355685	19357723	JUNC00001019	384	+	72	72	-304.0	-304.0	-304.0
chrX	19357719	19358915	19357649	19358990	JUNC00001020	372	+	70	75	-304.0	-304.0	-304.0
chrX	19359024	19359488	19358949	19359563	JUNC00001021	341	+	75	75	-304.0	-304.0	-304.0
chrX	19360833	19361338	19360775	19361356	JUNC00001022	1	-	58	18	-304.0	-304.0	-304.0
chrX	19361415	19361492	19361345	19361543	JUNC00001023	2	-	70	51	-304.0	-304.0	-304.0
chrX	19392107	19392342	19392089	19392400	JUNC00001024	1	-	18	58	-304.0	-304.0	-304.0
chrX	19407283	19409923	19407228	19409944	JUNC00001025	1	-	55	21	-304.0	-304.0	-304.0
chrX	19409973	19413356	19409943	19413402	JUNC00001026	1	-	30	46	-304.0	-304.0	-304.0
chrX	19413613	19413923	19413586	19413965	JUNC00001027	1	+	27	42	-304.0	-304.0	-304.0
chrX	19415257	19425530	19415219	19425565	JUNC00001028	1	-	38	35	-304.0	-304.0	-304.0
chrX	19425690	19426230	19425632	19426248	JUNC00001029	1	-	58	18	-304.0	-304.0	-304.0
chrX	19426343	19431437	19426288	19431490	JUNC00001030	2	-	55	53	-304.0	-304.0	-304.0
chrX	19460153	19464212	19460113	19464248	JUNC00001031	1	-	40	36	-304.0	-304.0	-304.0
chrX	19507949	19538668	19507917	19538712	JUNC00001032	1	-	32	44	-304.0	-304.0	-304.0
chrX	19536458	19537716	19536383	19537782	JUNC00001033	580	-	75	66	-304.0	-304.0	-304.0
chrX	19537780	19541924	19537716	19541999	JUNC00001034	572	-	64	75	-304.0	-304.0	-304.0
chrX	19542075	19545921	19542029	19545951	JUNC00001035	1	-	46	30	-304.0	-304.0	-304.0
chrX	19542193	19545921	19542120	19545996	JUNC00001037	379	-	73	75	-304.0	-304.0	-304.0
chrX	19542193	19549973	19542118	19550046	JUNC00001036	11	-	75	73	-304.0	-304.0	-304.0
chrX	19546050	19549973	19545975	19550048	JUNC00001038	644	-	75	75	-304.0	-304.0	-304.0
chrX	19550083	19569102	19550008	19569177	JUNC00001039	764	-	75	75	-304.0	-304.0	-304.0
chrX	19569188	19588642	19569113	19588717	JUNC00001040	668	-	75	75	-304.0	-304.0	-304.0
chrX	19588798	19592066	19588724	19592141	JUNC00001041	33	-	74	75	-304.0	-304.0	-304.0
chrX	19588802	19591042	19588769	19591085	JUNC00001043	1	-	33	43	-304.0	-304.0	-304.0
chrX	19588802	19592066	19588727	19592141	JUNC00001042	625	-	75	75	-304.0	-304.0	-304.0
chrX	19591087	19592066	19591042	19592094	JUNC00001044	1	-	45	28	-304.0	-304.0	-304.0
chrX	19592147	19594948	19592072	19595002	JUNC00001045	633	-	75	54	-304.0	-304.0	-304.0
chrX	19595000	19607937	19594947	19608012	JUNC00001046	518	-	53	75	-304.0	-304.0	-304.0
chrX	19601650	19607937	19601626	19607989	JUNC00001047	2	-	24	52	-304.0	-304.0	-304.0
chrX	19608045	19631863	19607970	19631938	JUNC00001048	546	-	75	75	-304.0	-304.0	-304.0
chrX	19608045	19706880	19607970	19706955	JUNC00001049	5	-	75	75	-304.0	-304.0	-304.0
chrX	19631958	19645399	19631883	19645474	JUNC00001050	819	-	75	75	-304.0	-304.0	-304.0
chrX	19645475	19647512	19645434	19647547	JUNC00001053	1	-	41	35	-304.0	-304.0	-304.0
chrX	19645475	19683822	19645400	19683897	JUNC00001051	706	-	75	75	-304.0	-304.0	-304.0
chrX	19645475	19695611	19645414	19695658	JUNC00001052	3	-	61	47	-304.0	-304.0	-304.0
chrX	19684028	19687616	19683953	19687647	JUNC00001055	8	-	75	31	-304.0	-304.0	-304.0
chrX	19684028	19694994	19684010	19695051	JUNC00001056	1	-	18	57	-304.0	-304.0	-304.0
chrX	19684028	19695611	19683953	19695686	JUNC00001054	770	-	75	75	-304.0	-304.0	-304.0
chrX	19687691	19695611	19687652	19695686	JUNC00001057	14	-	39	75	-304.0	-304.0	-304.0
chrX	19695741	19706880	19695666	19706955	JUNC00001058	445	-	75	75	-304.0	-304.0	-304.0
chrX	19706984	19746317	19706909	19746392	JUNC00001059	341	-	75	75	-304.0	-304.0	-304.0
chrX	19720049	19746317	19720000	19746344	JUNC00001060	1	-	49	27	-304.0	-304.0	-304.0
chrX	19746441	19746606	19746379	19746676	JUNC00001070	4	-	62	70	-304.0	-304.0	-304.0
chrX	19746441	19746623	19746367	19746645	JUNC00001063	3	-	74	22	-304.0	-304.0	-304.0
chrX	19746441	19746792	19746367	19746846	JUNC00001062	2	-	74	54	-304.0	-304.0	-304.0
chrX	19746441	19747314	19746377	19747359	JUNC00001068	3	-	64	45	-304.0	-304.0	-304.0
chrX	19746441	19747708	19746377	19747753	JUNC00001069	3	-	64	45	-304.0	-304.0	-304.0
chrX	19746441	19747895	19746367	19747969	JUNC00001065	21	-	74	74	-304.0	-304.0	-304.0
chrX	19746441	19755902	19746400	19755957	JUNC00001072	2	-	41	55	-304.0	-304.0	-304.0
chrX	19746441	19755987	19746405	19756026	JUNC00001073	1	-	36	39	-304.0	-304.0	-304.0
chrX	19746441	19799633	19746369	19799684	JUNC00001067	5	-	72	51	-304.0	-304.0	-304.0
chrX	19746441	19807366	19746367	19807440	JUNC00001064	11	-	74	74	-304.0	-304.0	-304.0
chrX	19746441	19833078	19746395	19833108	JUNC00001071	1	-	46	30	-304.0	-304.0	-304.0
chrX	19746441	19836124	19746367	19836199	JUNC00001061	250	-	74	75	-304.0	-304.0	-304.0
chrX	19746441	19836150	19746368	19836225	JUNC00001066	26	-	73	75	-304.0	-304.0	-304.0
chrX	19746441	19887306	19746414	19887355	JUNC00001074	1	-	27	49	-304.0	-304.0	-304.0
chrX	19756092	19836124	19756032	19836199	JUNC00001075	11	-	60	75	-304.0	-304.0	-304.0
chrX	19756092	19836150	19756052	19836224	JUNC00001076	3	-	40	74	-304.0	-304.0	-304.0
chrX	19836282	19864793	19836207	19864854	JUNC00001078	5	-	75	61	-304.0	-304.0	-304.0
chrX	19836282	19866203	19836207	19866234	JUNC00001077	2	-	75	31	-304.0	-304.0	-304.0
chrX	19836282	19887306	19836207	19887375	JUNC00001079	87	-	75	69	-304.0	-304.0	-304.0
chrX	19873034	19875054	19872976	19875072	JUNC00001080	1	-	58	18	-304.0	-304.0	-304.0
chrX	19914268	19914350	19914217	19914375	JUNC00001081	1	-	51	25	-304.0	-304.0	-304.0
chrX	19914426	19914938	19914369	19914957	JUNC00001082	1	-	57	19	-304.0	-304.0	-304.0
chrX	19917334	19929784	19917271	19929855	JUNC00001083	6	-	63	71	-304.0	-304.0	-304.0
chrX	19917334	19935808	19917317	19935867	JUNC00001084	1	-	17	59	-304.0	-304.0	-304.0
chrX	19924907	19925985	19924876	19926030	JUNC00001085	1	-	31	45	-304.0	-304.0	-304.0
chrX	19929940	19935808	19929895	19935883	JUNC00001086	4	-	45	75	-304.0	-304.0	-304.0
chrX	19935898	19937504	19935824	19937532	JUNC00001087	6	-	74	28	-304.0	-304.0	-304.0
chrX	19937532	19950752	19937470	19950815	JUNC00001088	8	-	62	63	-304.0	-304.0	-304.0
chrX	19950868	19952987	19950797	19953048	JUNC00001089	14	-	71	61	-304.0	-304.0	-304.0
chrX	19953051	19953777	19952988	19953849	JUNC00001090	14	-	63	72	-304.0	-304.0	-304.0
chrX	19953892	19955390	19953824	19955452	JUNC00001091	9	-	68	62	-304.0	-304.0	-304.0
chrX	19953892	19965043	19953840	19965067	JUNC00001092	1	-	52	24	-304.0	-304.0	-304.0
chrX	19954210	19955390	19954166	19955422	JUNC00001093	1	-	44	32	-304.0	-304.0	-304.0
chrX	19955506	19965043	19955466	19965117	JUNC00001094	4	-	40	74	-304.0	-304.0	-304.0
chrX	19955566	19965043	19955493	19965098	JUNC00001095	8	-	73	55	-304.0	-304.0	-304.0
chrX	19965706	19966079	19965658	19966145	JUNC00001096	5	-	48	66	-304.0	-304.0	-304.0
chrX	19966649	19970223	19966576	19970275	JUNC00001097	5	-	73	52	-304.0	-304.0	-304.0
chrX	19993670	20002681	19993645	20002732	JUNC00001098	1	+	25	51	-304.0	-304.0	-304.0
chrX	20008398	20010776	20008356	20010831	JUNC00001099	7	-	42	55	-304.0	-304.0	-304.0
chrX	20011052	20012348	20010981	20012410	JUNC00001100	6	-	71	62	-304.0	-304.0	-304.0
chrX	20012535	20013053	20012463	20013127	JUNC00001101	14	-	72	74	-304.0	-304.0	-304.0
chrX	20013132	20013568	20013081	20013627	JUNC00001102	16	-	51	59	-304.0	-304.0	-304.0
chrX	20013625	20015222	20013568	20015296	JUNC00001103	12	-	57	74	-304.0	-304.0	-304.0
chrX	20015327	20016093	20015254	20016165	JUNC00001104	16	-	73	72	-304.0	-304.0	-304.0
chrX	20016325	20024950	20016253	20025019	JUNC00001105	8	-	72	69	-304.0	-304.0	-304.0
chrX	20021549	20024950	20021523	20025015	JUNC00001106	2	-	26	65	-304.0	-304.0	-304.0
chrX	20025083	20025680	20025009	20025739	JUNC00001107	20	-	74	59	-304.0	-304.0	-304.0
chrX	20025952	20042501	20025878	20042576	JUNC00001108	17	-	74	75	-304.0	-304.0	-304.0
chrX	20042629	20044363	20042558	20044436	JUNC00001109	20	-	71	73	-304.0	-304.0	-304.0
chrX	20044524	20050823	20044451	20050869	JUNC00001110	10	-	73	46	-304.0	-304.0	-304.0
chrX	20052988	20056679	20052923	20056735	JUNC00001111	10	-	65	56	-304.0	-304.0	-304.0
chrX	20128311	20130515	20128237	20130587	JUNC00001112	38	-	74	72	-304.0	-304.0	-304.0
chrX	20130607	20132181	20130532	20132256	JUNC00001113	213	-	75	75	-304.0	-304.0	-304.0
chrX	20132263	20133956	20132188	20134009	JUNC00001114	90	-	75	53	-304.0	-304.0	-304.0
chrX	20134007	20135737	20133956	20135810	JUNC00001115	52	-	51	73	-304.0	-304.0	-304.0
chrX	20135841	20138538	20135766	20138613	JUNC00001116	76	-	75	75	-304.0	-304.0	-304.0
chrX	20138622	20141624	20138547	20141697	JUNC00001117	26	-	75	73	-304.0	-304.0	-304.0
chrX	20151368	20155429	20151318	20155500	JUNC00001118	6	-	50	71	-304.0	-304.0	-304.0
chrX	20151386	20155429	20151368	20155487	JUNC00001119	1	-	18	58	-304.0	-304.0	-304.0
chrX	20155520	20156108	20155445	20156183	JUNC00001120	103	-	75	75	-304.0	-304.0	-304.0
chrX	20156249	20161643	20156175	20161716	JUNC00001121	100	-	74	73	-304.0	-304.0	-304.0
chrX	20161761	20162963	20161686	20163036	JUNC00001122	93	-	75	73	-304.0	-304.0	-304.0
chrX	20163040	20164898	20162965	20164970	JUNC00001123	93	-	75	72	-304.0	-304.0	-304.0
chrX	20165060	20167588	20164985	20167663	JUNC00001124	70	-	75	75	-304.0	-304.0	-304.0
chrX	20167747	20169401	20167675	20169471	JUNC00001125	72	-	72	70	-304.0	-304.0	-304.0
chrX	20169491	20172745	20169419	20172817	JUNC00001126	57	-	72	72	-304.0	-304.0	-304.0
chrX	20172868	20175163	20172793	20175236	JUNC00001127	14	-	75	73	-304.0	-304.0	-304.0
chrX	20172871	20175163	20172796	20175238	JUNC00001128	56	-	75	75	-304.0	-304.0	-304.0
chrX	20175288	20176249	20175217	20176323	JUNC00001129	68	-	71	74	-304.0	-304.0	-304.0
chrX	20176352	20176433	20176278	20176498	JUNC00001130	50	-	74	65	-304.0	-304.0	-304.0
chrX	20176498	20176995	20176433	20177070	JUNC00001131	53	-	65	75	-304.0	-304.0	-304.0
chrX	20177084	20186295	20177009	20186367	JUNC00001132	84	-	75	72	-304.0	-304.0	-304.0
chrX	20186366	20187827	20186295	20187900	JUNC00001133	79	-	71	73	-304.0	-304.0	-304.0
chrX	20187970	20188496	20187897	20188545	JUNC00001134	72	-	73	49	-304.0	-304.0	-304.0
chrX	20188534	20193486	20188496	20193561	JUNC00001135	64	-	38	75	-304.0	-304.0	-304.0
chrX	20193593	20194188	20193518	20194259	JUNC00001136	58	-	75	71	-304.0	-304.0	-304.0
chrX	20194268	20195064	20194193	20195139	JUNC00001137	79	-	75	75	-304.0	-304.0	-304.0
chrX	20194268	20204021	20194235	20204064	JUNC00001138	1	-	33	43	-304.0	-304.0	-304.0
chrX	20195145	20204021	20195070	20204093	JUNC00001139	77	-	75	72	-304.0	-304.0	-304.0
chrX	20204103	20209287	20204028	20209362	JUNC00001140	46	-	75	75	-304.0	-304.0	-304.0
chrX	20209404	20234757	20209329	20234818	JUNC00001141	71	-	75	61	-304.0	-304.0	-304.0
chrX	20234814	20240568	20234757	20240607	JUNC00001142	6	-	57	39	-304.0	-304.0	-304.0
chrX	20234814	20266563	20234756	20266637	JUNC00001143	41	-	58	74	-304.0	-304.0	-304.0
chrX	20234814	20267382	20234769	20267413	JUNC00001144	1	-	45	31	-304.0	-304.0	-304.0
chrX	20240605	20241592	20240568	20241650	JUNC00001145	4	-	37	58	-304.0	-304.0	-304.0
chrX	20240605	20266563	20240572	20266606	JUNC00001146	1	-	33	43	-304.0	-304.0	-304.0
chrX	20240669	20241592	20240632	20241631	JUNC00001147	1	-	37	39	-304.0	-304.0	-304.0
chrX	20241686	20266563	20241623	20266602	JUNC00001148	4	-	63	39	-304.0	-304.0	-304.0
chrX	21374961	21426496	21374920	21426531	JUNC00001149	1	+	41	35	-304.0	-304.0	-304.0
chrX	21440781	21470765	21440744	21470804	JUNC00001150	1	+	37	39	-304.0	-304.0	-304.0
chrX	21501588	21516484	21501519	21516510	JUNC00001151	2	+	69	26	-304.0	-304.0	-304.0
chrX	21516631	21526866	21516610	21526921	JUNC00001152	1	+	21	55	-304.0	-304.0	-304.0
chrX	21527000	21531855	21526932	21531930	JUNC00001153	3	+	68	75	-304.0	-304.0	-304.0
chrX	21532067	21561470	21532039	21561519	JUNC00001154	2	+	28	49	-304.0	-304.0	-304.0
chrX	21561560	21563237	21561534	21563287	JUNC00001155	1	+	26	50	-304.0	-304.0	-304.0
chrX	21563452	21590571	21563395	21590616	JUNC00001156	3	+	57	45	-304.0	-304.0	-304.0
chrX	21595395	21601281	21595337	21601299	JUNC00001157	1	+	58	18	-304.0	-304.0	-304.0
chrX	21601349	21606778	21601306	21606833	JUNC00001158	3	+	43	55	-304.0	-304.0	-304.0
chrX	21606879	21609070	21606830	21609131	JUNC00001159	4	+	49	61	-304.0	-304.0	-304.0
chrX	21649027	21652305	21648988	21652354	JUNC00001160	2	+	39	49	-304.0	-304.0	-304.0
chrX	21839809	21843169	21839740	21843242	JUNC00001161	26	+	69	73	-304.0	-304.0	-304.0
chrX	21843318	21845170	21843247	21845237	JUNC00001162	29	+	71	67	-304.0	-304.0	-304.0
chrX	21845384	21851508	21845311	21851575	JUNC00001163	45	+	73	67	-304.0	-304.0	-304.0
chrX	21851612	21853375	21851537	21853441	JUNC00001164	13	+	75	66	-304.0	-304.0	-304.0
chrX	21853503	21856482	21853452	21856507	JUNC00001166	1	+	51	25	-304.0	-304.0	-304.0
chrX	21853503	21856500	21853460	21856565	JUNC00001168	2	+	43	65	-304.0	-304.0	-304.0
chrX	21853503	21857260	21853468	21857301	JUNC00001169	1	+	35	41	-304.0	-304.0	-304.0
chrX	21853503	21868466	21853430	21868531	JUNC00001165	18	+	73	65	-304.0	-304.0	-304.0
chrX	21853503	21878041	21853452	21878076	JUNC00001167	2	+	51	35	-304.0	-304.0	-304.0
chrX	21857025	21857260	21856995	21857306	JUNC00001170	1	+	30	46	-304.0	-304.0	-304.0
chrX	21868585	21869497	21868519	21869572	JUNC00001171	17	+	66	75	-304.0	-304.0	-304.0
chrX	21869678	21878041	21869606	21878102	JUNC00001172	17	+	72	61	-304.0	-304.0	-304.0
chrX	21878136	21878496	21878067	21878565	JUNC00001173	14	+	69	69	-304.0	-304.0	-304.0
chrX	21878692	21880896	21878617	21880963	JUNC00001174	28	+	75	67	-304.0	-304.0	-304.0
chrX	21880972	21882432	21880897	21882505	JUNC00001175	35	+	75	73	-304.0	-304.0	-304.0
chrX	21882651	21898052	21882601	21898097	JUNC00001176	2	+	50	45	-304.0	-304.0	-304.0
chrX	21898233	21911602	21898208	21911653	JUNC00001177	1	+	25	51	-304.0	-304.0	-304.0
chrX	21917205	22179632	21917159	22179662	JUNC00001178	1	+	46	30	106.0	122.0	122.0
chrX	21940873	21967195	21940800	21967269	JUNC00001179	127	+	73	74	-304.0	-304.0	-304.0
chrX	21967316	21971896	21967242	21971971	JUNC00001180	290	+	74	75	-304.0	-304.0	-304.0
chrX	21967316	21977060	21967246	21977132	JUNC00001181	7	+	70	72	-304.0	-304.0	-304.0
chrX	21971990	21972506	21971915	21972571	JUNC00001182	307	+	75	65	-304.0	-304.0	-304.0
chrX	21972571	21977060	21972506	21977135	JUNC00001183	286	+	65	75	-304.0	-304.0	-304.0
chrX	21977236	21977959	21977162	21978034	JUNC00001184	280	+	74	75	-304.0	-304.0	-304.0
chrX	21978966	21984303	21978891	21984378	JUNC00001185	319	+	75	75	-304.0	-304.0	-304.0
chrX	21984418	21985143	21984343	21985217	JUNC00001186	247	+	75	74	-304.0	-304.0	-304.0
chrX	21985223	21992596	21985148	21992671	JUNC00001187	389	+	75	75	-304.0	-304.0	-304.0
chrX	21992712	21994311	21992637	21994386	JUNC00001188	359	+	75	75	-304.0	-304.0	-304.0
chrX	22033123	22038468	22033085	22038506	JUNC00001189	1	+	38	38	-304.0	-304.0	-304.0
chrX	22060859	22076387	22060803	22076407	JUNC00001190	1	+	56	20	-304.0	-304.0	-304.0
chrX	22090497	22093982	22090438	22093999	JUNC00001191	1	+	59	17	-304.0	-304.0	-304.0
chrX	22092982	22140712	22092958	22140767	JUNC00001192	2	-	24	55	-304.0	-304.0	-304.0
chrX	22097038	22099005	22096988	22099031	JUNC00001193	1	+	50	26	-304.0	-304.0	-304.0
chrX	22114586	22133522	22114535	22133547	JUNC00001194	1	+	51	25	-304.0	-304.0	-304.0
chrX	22168389	22178272	22168341	22178316	JUNC00001195	2	+	48	44	-304.0	-304.0	-304.0
chrX	22221743	22226442	22221688	22226495	JUNC00001196	2	+	55	53	-304.0	-304.0	-304.0
chrX	22245409	22247850	22245362	22247879	JUNC00001197	1	+	47	29	-304.0	-304.0	-304.0
chrX	22425405	22430672	22425354	22430697	JUNC00001198	1	+	51	25	-304.0	-304.0	-304.0
chrX	23076327	23076656	23076278	23076724	JUNC00001199	16	?	49	68	-304.0	-304.0	-304.0
chrX	23667811	23671528	23667736	23671603	JUNC00001200	294	+	75	75	-304.0	-304.0	-304.0
chrX	23671646	23674989	23671571	23675064	JUNC00001201	232	+	75	75	-304.0	-304.0	-304.0
chrX	23675106	23679164	23675031	23679238	JUNC00001202	264	+	75	74	-304.0	-304.0	-304.0
chrX	23675106	23682395	23675066	23682468	JUNC00001203	2	+	40	73	-304.0	-304.0	-304.0
chrX	23679287	23682395	23679212	23682470	JUNC00001204	237	+	75	75	-304.0	-304.0	-304.0
chrX	23682526	23683670	23682452	23683705	JUNC00001205	172	+	74	35	-304.0	-304.0	-304.0
chrX	23683705	23686284	23683668	23686359	JUNC00001206	70	+	37	75	-304.0	-304.0	-304.0
chrX	23699103	23746686	23699049	23746707	JUNC00001207	1	-	54	21	-304.0	-304.0	-304.0
chrX	23701813	23725210	23701792	23725252	JUNC00001208	1	-	21	42	-304.0	-304.0	-304.0
chrX	23703982	23704693	23703907	23704768	JUNC00001209	114	-	75	75	-304.0	-304.0	-304.0
chrX	23704844	23704992	23704770	23705065	JUNC00001210	79	-	74	73	-304.0	-304.0	-304.0
chrX	23705080	23705497	23705046	23705539	JUNC00001212	1	-	34	42	-304.0	-304.0	-304.0
chrX	23705080	23705508	23705006	23705583	JUNC00001211	70	-	74	75	-304.0	-304.0	-304.0
chrX	23705594	23705767	23705524	23705841	JUNC00001213	102	-	70	74	-304.0	-304.0	-304.0
chrX	23705858	23706618	23705806	23706642	JUNC00001215	1	-	52	24	-304.0	-304.0	-304.0
chrX	23705858	23706627	23705784	23706698	JUNC00001214	68	-	74	71	-304.0	-304.0	-304.0
chrX	23706201	23726135	23706178	23726188	JUNC00001216	1	+	23	53	-304.0	-304.0	-304.0
chrX	23706739	23707876	23706665	23707946	JUNC00001217	119	-	74	70	-304.0	-304.0	-304.0
chrX	23707708	23707879	23707667	23707914	JUNC00001220	1	?	41	35	-304.0	-304.0	-304.0
chrX	23707708	23707879	23707707	23707944	JUNC00001221	1	-	1	65	-304.0	-304.0	-304.0
chrX	23707944	23713134	23707876	23713206	JUNC00001219	142	-	68	72	-304.0	-304.0	-304.0
chrX	23707944	23721880	23707876	23721931	JUNC00001218	5	-	68	51	-304.0	-304.0	-304.0
chrX	23708523	23713134	23708477	23713164	JUNC00001223	1	-	46	30	-304.0	-304.0	-304.0
chrX	23708523	23721880	23708472	23721918	JUNC00001222	3	-	51	38	-304.0	-304.0	-304.0
chrX	23712172	23717995	23712155	23718054	JUNC00001225	1	+	17	59	-304.0	-304.0	-304.0
chrX	23712186	23737099	23712153	23737142	JUNC00001224	1	+	33	43	-304.0	-304.0	-304.0
chrX	23713208	23721880	23713134	23721954	JUNC00001226	106	-	74	74	-304.0	-304.0	-304.0
chrX	23721984	23722669	23721910	23722738	JUNC00001227	121	-	74	69	-304.0	-304.0	-304.0
chrX	23722753	23730526	23722678	23730565	JUNC00001228	117	-	75	39	-304.0	-304.0	-304.0
chrX	23730564	23730815	23730524	23730889	JUNC00001229	108	-	40	74	-304.0	-304.0	-304.0
chrX	23730986	23733171	23730911	23733219	JUNC00001230	86	-	75	48	-304.0	-304.0	-304.0
chrX	23733217	23734340	23733171	23734369	JUNC00001231	41	-	46	29	-304.0	-304.0	-304.0
chrX	23733660	23746537	23733638	23746591	JUNC00001232	1	-	22	54	-304.0	-304.0	-304.0
chrX	23736016	23743124	23735942	23743187	JUNC00001233	37	-	74	63	-304.0	-304.0	-304.0
chrX	23770296	23782567	23770254	23782601	JUNC00001234	1	-	42	34	-304.0	-304.0	-304.0
chrX	23773510	23777717	23773484	23777767	JUNC00001235	1	-	26	50	-304.0	-304.0	-304.0
chrX	23775056	23791080	23775035	23791135	JUNC00001236	1	-	21	55	-304.0	-304.0	-304.0
chrX	23777851	23782567	23777799	23782591	JUNC00001237	1	-	52	24	-304.0	-304.0	-304.0
chrX	23783417	23783643	23783381	23783683	JUNC00001239	1	?	36	40	-304.0	-304.0	-304.0
chrX	23783417	23783657	23783342	23783719	JUNC00001238	309	+	75	62	-304.0	-304.0	-304.0
chrX	23783709	23783799	23783655	23783874	JUNC00001240	331	+	54	75	-304.0	-304.0	-304.0
chrX	23783883	23784293	23783808	23784367	JUNC00001241	21	+	75	74	-304.0	-304.0	-304.0
chrX	23783883	23785327	23783808	23785402	JUNC00001242	300	+	75	75	-304.0	-304.0	-304.0
chrX	23784139	23785327	23784064	23785344	JUNC00001243	2	+	75	17	-304.0	-304.0	-304.0
chrX	23784403	23785327	23784329	23785402	JUNC00001244	66	+	74	75	-304.0	-304.0	-304.0
chrX	23785429	23785519	23785354	23785562	JUNC00001245	325	+	75	43	-304.0	-304.0	-304.0
chrX	23785560	23785685	23785513	23785759	JUNC00001246	377	+	47	74	-304.0	-304.0	-304.0
chrX	23826739	23840312	23826684	23840377	JUNC00001247	2	-	55	65	-304.0	-304.0	-304.0
chrX	23833510	23840312	23833435	23840382	JUNC00001249	36	-	75	70	-304.0	-304.0	-304.0
chrX	23833612	23840312	23833541	23840382	JUNC00001250	36	-	71	70	-304.0	-304.0	-304.0
chrX	23836680	23836905	23836644	23836945	JUNC00001251	1	?	36	40	-304.0	-304.0	-304.0
chrX	23836712	23836933	23836657	23836954	JUNC00001252	1	?	55	21	-304.0	-304.0	-304.0
chrX	23836848	23836929	23836773	23837004	JUNC00001253	50	-	75	75	-304.0	-304.0	-304.0
chrX	23836856	23836885	23836781	23836920	JUNC00001254	2	?	75	35	94.0	-304.0	94.0
chrX	23836891	23836981	23836848	23837014	JUNC00001255	1	?	43	33	-304.0	-304.0	-304.0
chrX	23836946	23837042	23836871	23837117	JUNC00001256	48	-	75	75	-304.0	-304.0	-304.0
chrX	23836951	23837116	23836928	23837169	JUNC00001257	1	?	23	53	-304.0	-304.0	-304.0
chrX	23837079	23837115	23837004	23837187	JUNC00001258	5	?	75	72	-304.0	-304.0	-304.0
chrX	23837079	23837123	23837004	23837158	JUNC00001259	5	?	75	35	-304.0	-304.0	-304.0
chrX	23837083	23837122	23837059	23837191	JUNC00001261	2	+	24	69	-304.0	-304.0	-304.0
chrX	23837084	23837168	23837010	23837215	JUNC00001260	7	?	74	47	-304.0	-304.0	-304.0
chrX	23837203	23837225	23837183	23837281	JUNC00001262	1	?	20	56	108.0	108.0	108.0
chrX	23840377	23856301	23840312	23856375	JUNC00001248	71	-	65	74	-304.0	-304.0	-304.0
chrX	23856382	23858641	23856311	23858716	JUNC00001263	99	-	71	75	-304.0	-304.0	-304.0
chrX	23858733	23868592	23858664	23868667	JUNC00001264	77	-	69	75	-304.0	-304.0	-304.0
chrX	23868688	23874402	23868615	23874459	JUNC00001265	66	-	73	57	-304.0	-304.0	-304.0
chrX	23868688	23878914	23868624	23878953	JUNC00001266	2	-	64	39	-304.0	-304.0	-304.0
chrX	23874457	23878914	23874402	23878989	JUNC00001267	66	-	55	75	-304.0	-304.0	-304.0
chrX	23879034	23880844	23878962	23880917	JUNC00001268	66	-	72	73	-304.0	-304.0	-304.0
chrX	23879034	23907693	23878962	23907715	JUNC00001269	2	-	72	22	-304.0	-304.0	-304.0
chrX	23880952	23907693	23880877	23907746	JUNC00001270	36	-	75	53	-304.0	-304.0	-304.0
chrX	23910418	23911756	23910365	23911815	JUNC00001271	2	+	53	59	-304.0	-304.0	-304.0
chrX	23916328	23927238	23916297	23927283	JUNC00001272	1	+	31	45	-304.0	-304.0	-304.0
chrX	23935339	23953102	23935297	23953136	JUNC00001273	1	-	42	34	-304.0	-304.0	-304.0
chrX	23946859	23953102	23946817	23953136	JUNC00001274	1	-	42	34	-304.0	-304.0	-304.0
chrX	23989030	24005988	23988955	24006061	JUNC00001275	29	-	75	73	-304.0	-304.0	-304.0
chrX	24006700	24024856	24006638	24024924	JUNC00001276	11	-	62	68	-304.0	-304.0	-304.0
chrX	24015934	24043132	24015899	24043173	JUNC00001277	1	+	35	41	-304.0	-304.0	-304.0
chrX	24042448	24073600	24042417	24073644	JUNC00001278	2	+	31	44	-304.0	-304.0	-304.0
chrX	24052365	24077211	24052338	24077286	JUNC00001279	18	+	27	75	-304.0	-304.0	-304.0
chrX	24055037	24055614	24054971	24055681	JUNC00001280	579	+	66	67	-304.0	-304.0	-304.0
chrX	24055083	24055614	24055056	24055663	JUNC00001282	1	+	27	49	-304.0	-304.0	-304.0
chrX	24055678	24057420	24055614	24057495	JUNC00001281	593	+	64	75	-304.0	-304.0	-304.0
chrX	24057548	24057632	24057473	24057707	JUNC00001283	471	+	75	75	-304.0	-304.0	-304.0
chrX	24057548	24057641	24057496	24057715	JUNC00001284	3	+	52	74	-304.0	-304.0	-304.0
chrX	24057754	24060087	24057679	24060162	JUNC00001285	595	+	75	75	-304.0	-304.0	-304.0
chrX	24060182	24061808	24060121	24061844	JUNC00001287	2	+	61	36	-304.0	-304.0	-304.0
chrX	24060182	24061935	24060123	24061952	JUNC00001288	1	+	59	17	-304.0	-304.0	-304.0
chrX	24060182	24062415	24060107	24062488	JUNC00001286	700	+	75	73	-304.0	-304.0	-304.0
chrX	24062009	24062415	24061986	24062468	JUNC00001289	1	+	23	53	-304.0	-304.0	-304.0
chrX	24062574	24062955	24062537	24062994	JUNC00001291	1	+	37	39	-304.0	-304.0	-304.0
chrX	24062574	24064200	24062499	24064275	JUNC00001290	448	+	75	75	-304.0	-304.0	-304.0
chrX	24064335	24065997	24064262	24066072	JUNC00001292	158	+	73	75	-304.0	-304.0	-304.0
chrX	24066092	24067963	24066017	24068037	JUNC00001293	478	+	75	74	-304.0	-304.0	-304.0
chrX	24068108	24071557	24068033	24071632	JUNC00001294	577	+	75	75	-304.0	-304.0	-304.0
chrX	24071727	24072467	24071704	24072520	JUNC00001297	1	+	23	53	-304.0	-304.0	-304.0
chrX	24071727	24073090	24071653	24073165	JUNC00001295	516	+	74	75	-304.0	-304.0	-304.0
chrX	24071727	24076721	24071667	24076796	JUNC00001296	34	+	60	75	-304.0	-304.0	-304.0
chrX	24073263	24075888	24073189	24075905	JUNC00001299	2	+	74	17	-304.0	-304.0	-304.0
chrX	24073263	24076721	24073189	24076796	JUNC00001298	656	+	74	75	-304.0	-304.0	-304.0
chrX	24076640	24076721	24076610	24076796	JUNC00001300	21	+	30	75	-304.0	-304.0	-304.0
chrX	24112208	24118327	24112183	24118378	JUNC00001301	1	+	25	51	-304.0	116.0	116.0
chrX	24149253	24151690	24149204	24151721	JUNC00001302	2	+	49	31	-304.0	-304.0	-304.0
chrX	24149794	24151690	24149767	24151763	JUNC00001303	5	+	27	73	-304.0	-304.0	-304.0
chrX	24150167	24151690	24150134	24151733	JUNC00001304	1	+	33	43	-304.0	-304.0	-304.0
chrX	24151800	24152699	24151775	24152750	JUNC00001306	1	+	25	51	-304.0	-304.0	-304.0
chrX	24151800	24152719	24151734	24152788	JUNC00001305	17	+	66	69	-304.0	-304.0	-304.0
chrX	24152830	24161714	24152794	24161775	JUNC00001308	2	+	36	61	-304.0	-304.0	-304.0
chrX	24152830	24172714	24152755	24172775	JUNC00001307	14	+	75	61	-304.0	-304.0	-304.0
chrX	24161842	24172714	24161790	24172738	JUNC00001309	1	+	52	24	-304.0	-304.0	-304.0
chrX	24172800	24173606	24172740	24173656	JUNC00001312	4	+	60	50	-304.0	-304.0	-304.0
chrX	24172800	24175388	24172727	24175421	JUNC00001310	2	+	73	33	-304.0	-304.0	-304.0
chrX	24172800	24179182	24172732	24179252	JUNC00001311	26	+	68	70	-304.0	-304.0	-304.0
chrX	24173723	24179182	24173676	24179211	JUNC00001313	1	+	47	29	-304.0	-304.0	-304.0
chrX	24174475	24183266	24174460	24183327	JUNC00001314	1	-	15	61	-304.0	-304.0	-304.0
chrX	24175443	24177713	24175386	24177732	JUNC00001315	1	+	57	19	-304.0	-304.0	-304.0
chrX	24175443	24179182	24175387	24179209	JUNC00001316	2	+	56	27	-304.0	-304.0	-304.0
chrX	24179770	24207325	24179695	24207395	JUNC00001317	35	+	75	70	-304.0	-304.0	-304.0
chrX	24207475	24207711	24207420	24207782	JUNC00001318	25	+	55	71	-304.0	-304.0	-304.0
chrX	24207855	24208217	24207785	24208288	JUNC00001319	29	+	70	71	-304.0	-304.0	-304.0
chrX	24207859	24208217	24207837	24208271	JUNC00001320	1	+	22	54	-304.0	-304.0	-304.0
chrX	24208370	24208899	24208309	24208968	JUNC00001321	13	+	61	69	-304.0	-304.0	-304.0
chrX	24209040	24210192	24208966	24210266	JUNC00001322	33	+	74	74	-304.0	-304.0	-304.0
chrX	24243050	24279281	24243013	24279320	JUNC00001323	1	+	37	39	-304.0	-304.0	-304.0
chrX	24246926	24247234	24246895	24247269	JUNC00001324	1	-	31	35	-304.0	-304.0	-304.0
chrX	24258627	24269763	24258592	24269804	JUNC00001325	1	+	35	41	-304.0	116.0	116.0
chrX	24400606	24421999	24400575	24422044	JUNC00001326	1	-	31	45	-304.0	-304.0	-304.0
chrX	24429557	24429728	24429507	24429754	JUNC00001327	1	?	50	26	-304.0	-304.0	-304.0
chrX	24429656	24429708	24429626	24429754	JUNC00001328	1	?	30	46	-304.0	-304.0	-304.0
chrX	24429757	24429888	24429724	24429931	JUNC00001329	1	?	33	43	-304.0	-304.0	-304.0
chrX	24465561	24494741	24465493	24494812	JUNC00001330	33	+	68	71	-304.0	-304.0	-304.0
chrX	24478382	24479707	24478334	24479727	JUNC00001331	1	-	48	20	-304.0	-304.0	-304.0
chrX	24494883	24498828	24494808	24498900	JUNC00001332	72	+	75	72	-304.0	-304.0	-304.0
chrX	24498900	24503326	24498828	24503400	JUNC00001333	62	+	72	74	-304.0	-304.0	-304.0
chrX	24503511	24505208	24503439	24505283	JUNC00001334	78	+	72	75	-304.0	-304.0	-304.0
chrX	24505298	24518932	24505223	24519006	JUNC00001335	91	+	75	74	-304.0	-304.0	-304.0
chrX	24519010	24526197	24518936	24526272	JUNC00001336	88	+	74	75	-304.0	-304.0	-304.0
chrX	24525092	24556389	24525057	24556430	JUNC00001337	1	+	35	41	132.0	128.0	132.0
chrX	24526274	24527573	24526199	24527646	JUNC00001338	101	+	75	73	-304.0	-304.0	-304.0
chrX	24527675	24528075	24527600	24528148	JUNC00001339	88	+	75	73	-304.0	-304.0	-304.0
chrX	24528186	24531656	24528115	24531731	JUNC00001340	78	+	71	75	-304.0	-304.0	-304.0
chrX	24528186	24533928	24528159	24533977	JUNC00001341	1	+	27	49	-304.0	-304.0	-304.0
chrX	24531770	24533928	24531695	24534002	JUNC00001342	79	+	75	74	-304.0	-304.0	-304.0
chrX	24534068	24539133	24533994	24539206	JUNC00001343	56	+	74	73	-304.0	-304.0	-304.0
chrX	24579458	24587240	24579420	24587278	JUNC00001344	1	-	38	38	-304.0	-304.0	-304.0
chrX	24587319	24590022	24587289	24590068	JUNC00001345	1	-	30	46	-304.0	-304.0	-304.0
chrX	24607861	24618984	24607822	24619021	JUNC00001346	1	-	39	37	-304.0	-304.0	-304.0
chrX	24693986	24699424	24693922	24699484	JUNC00001347	4	+	64	60	-304.0	-304.0	-304.0
chrX	24694004	24699424	24693934	24699492	JUNC00001348	34	+	70	68	-304.0	-304.0	-304.0
chrX	24699549	24703250	24699478	24703323	JUNC00001349	37	+	71	73	-304.0	-304.0	-304.0
chrX	24699549	24930452	24699513	24930492	JUNC00001350	2	+	36	40	-304.0	-304.0	-304.0
chrX	24703347	24704388	24703272	24704463	JUNC00001351	54	+	75	75	-304.0	-304.0	-304.0
chrX	24704303	24704388	24704257	24704418	JUNC00001352	1	+	46	30	-304.0	-304.0	-304.0
chrX	24704469	24714553	24704398	24714628	JUNC00001353	67	+	71	75	-304.0	-304.0	-304.0
chrX	24714669	24715140	24714596	24715203	JUNC00001354	45	+	73	63	-304.0	-304.0	-304.0
chrX	24715203	24716361	24715140	24716435	JUNC00001355	41	+	63	74	-304.0	-304.0	-304.0
chrX	24716454	24716883	24716379	24716957	JUNC00001356	43	+	75	74	-304.0	-304.0	-304.0
chrX	24716971	24717289	24716896	24717363	JUNC00001357	57	+	75	74	-304.0	-304.0	-304.0
chrX	24717491	24717579	24717419	24717650	JUNC00001358	59	+	72	71	-304.0	-304.0	-304.0
chrX	24717758	24723154	24717684	24723225	JUNC00001359	53	+	74	71	-304.0	-304.0	-304.0
chrX	24723267	24724334	24723193	24724409	JUNC00001360	32	+	74	75	-304.0	-304.0	-304.0
chrX	24724451	24725980	24724376	24726055	JUNC00001361	40	+	75	75	-304.0	-304.0	-304.0
chrX	24726055	24726932	24725984	24727007	JUNC00001362	57	+	71	75	-304.0	-304.0	-304.0
chrX	24727071	24727781	24726997	24727856	JUNC00001363	55	+	74	75	-304.0	-304.0	-304.0
chrX	24727936	24732369	24727861	24732442	JUNC00001364	38	+	75	73	-304.0	-304.0	-304.0
chrX	24732454	24733754	24732379	24733828	JUNC00001365	37	+	75	74	-304.0	-304.0	-304.0
chrX	24733816	24735398	24733754	24735471	JUNC00001366	40	+	62	73	-304.0	-304.0	-304.0
chrX	24735488	24737624	24735417	24737699	JUNC00001367	47	+	71	75	-304.0	-304.0	-304.0
chrX	24737741	24739374	24737668	24739447	JUNC00001368	56	+	73	73	-304.0	-304.0	-304.0
chrX	24739550	24741374	24739475	24741449	JUNC00001369	50	+	75	75	-304.0	-304.0	-304.0
chrX	24741504	24742001	24741431	24742076	JUNC00001370	51	+	73	75	-304.0	-304.0	-304.0
chrX	24742121	24743229	24742055	24743303	JUNC00001371	49	+	66	74	-304.0	-304.0	-304.0
chrX	24743329	24745417	24743254	24745484	JUNC00001373	42	+	75	67	-304.0	-304.0	-304.0
chrX	24743329	24748310	24743254	24748332	JUNC00001372	2	+	75	22	-304.0	-304.0	-304.0
chrX	24745542	24748310	24745467	24748385	JUNC00001374	62	+	75	75	-304.0	-304.0	-304.0
chrX	24748460	24748869	24748390	24748939	JUNC00001375	56	+	70	70	-304.0	-304.0	-304.0
chrX	24748992	24809897	24748917	24809930	JUNC00001376	65	+	75	33	-304.0	-304.0	-304.0
chrX	24788653	24788674	24788615	24788749	JUNC00001378	6	?	38	75	110.0	110.0	110.0
chrX	24788687	24788711	24788657	24788757	JUNC00001380	1	?	30	46	104.0	104.0	104.0
chrX	24788687	24788774	24788643	24788806	JUNC00001379	1	?	44	32	-304.0	-304.0	-304.0
chrX	24788698	24788887	24788666	24788931	JUNC00001381	1	?	32	44	-304.0	-304.0	-304.0
chrX	24788737	24788856	24788667	24788908	JUNC00001382	2	?	70	52	-304.0	-304.0	-304.0
chrX	24809930	24810707	24809897	24810782	JUNC00001377	54	+	33	75	-304.0	-304.0	-304.0
chrX	24810800	24812657	24810725	24812732	JUNC00001383	63	+	75	75	-304.0	-304.0	-304.0
chrX	24812863	24814978	24812789	24815048	JUNC00001384	51	+	74	70	-304.0	-304.0	-304.0
chrX	24815111	24821451	24815043	24821523	JUNC00001385	66	+	68	72	-304.0	-304.0	-304.0
chrX	24821583	24826426	24821510	24826499	JUNC00001386	50	+	73	73	-304.0	-304.0	-304.0
chrX	24826601	24841651	24826526	24841726	JUNC00001387	37	+	75	75	-304.0	-304.0	-304.0
chrX	24841830	24843545	24841755	24843620	JUNC00001388	52	+	75	75	-304.0	-304.0	-304.0
chrX	24843677	24888005	24843602	24888080	JUNC00001389	51	+	75	75	-304.0	-304.0	-304.0
chrX	24888122	24930452	24888051	24930524	JUNC00001390	71	+	71	72	-304.0	-304.0	-304.0
chrX	24888122	24995804	24888077	24995834	JUNC00001391	1	+	45	30	-304.0	-304.0	-304.0
chrX	24930549	24987627	24930480	24987663	JUNC00001394	2	+	69	36	-304.0	-304.0	-304.0
chrX	24930549	24990692	24930474	24990734	JUNC00001393	8	+	75	42	-304.0	-304.0	-304.0
chrX	24930549	24995804	24930474	24995879	JUNC00001392	71	+	75	75	-304.0	-304.0	-304.0
chrX	25056690	25082081	25056645	25082112	JUNC00001395	1	-	45	31	-304.0	-304.0	-304.0
chrX	26910861	26916983	26910792	26917032	JUNC00001396	7	+	69	49	-304.0	-304.0	-304.0
chrX	26910861	26917492	26910820	26917527	JUNC00001397	1	+	41	35	-304.0	-304.0	-304.0
chrX	26917692	26918251	26917622	26918291	JUNC00001398	2	+	70	40	-304.0	-304.0	-304.0
chrX	27157770	27158419	27157722	27158447	JUNC00001399	1	-	48	28	-304.0	-304.0	-304.0
chrX	27157930	27158419	27157882	27158447	JUNC00001400	1	-	48	28	-304.0	-304.0	-304.0
chrX	27158369	27158419	27158321	27158447	JUNC00001401	1	-	48	28	-304.0	-304.0	-304.0
chrX	28305789	28355100	28305741	28355121	JUNC00001402	1	-	48	21	-304.0	-304.0	-304.0
chrX	29100141	29101866	29100118	29101908	JUNC00001403	1	+	23	42	-304.0	-304.0	-304.0
chrX	29546740	29555348	29546693	29555415	JUNC00001404	8	-	47	67	-304.0	-304.0	-304.0
chrX	29554219	29555348	29554189	29555391	JUNC00001405	1	-	30	43	-304.0	-304.0	-304.0
chrX	30474554	30481975	30474505	30482002	JUNC00001406	1	-	49	27	-304.0	-304.0	-304.0
chrX	30532689	30533567	30532648	30533602	JUNC00001407	1	-	41	35	-304.0	-304.0	-304.0
chrX	30534074	30576751	30534028	30576781	JUNC00001409	1	-	46	30	-304.0	-304.0	-304.0
chrX	30534077	30576751	30534015	30576808	JUNC00001408	3	-	62	57	-304.0	-304.0	-304.0
chrX	30548219	30549117	30548165	30549139	JUNC00001410	1	+	54	22	-304.0	-304.0	-304.0
chrX	30560356	30560816	30560316	30560863	JUNC00001412	2	-	40	47	-304.0	-304.0	-304.0
chrX	30560356	30576751	30560284	30576825	JUNC00001411	126	-	72	74	-304.0	-304.0	-304.0
chrX	30571152	30576751	30571111	30576786	JUNC00001413	1	-	41	35	-304.0	-304.0	-304.0
chrX	30576866	30577048	30576830	30577088	JUNC00001415	1	-	36	40	-304.0	-304.0	-304.0
chrX	30576866	30577637	30576793	30577711	JUNC00001414	159	-	73	74	-304.0	-304.0	-304.0
chrX	30605670	30624704	30605649	30624759	JUNC00001416	1	+	21	55	-304.0	-304.0	-304.0
chrX	30653615	30665510	30653540	30665580	JUNC00001417	39	+	75	70	-304.0	-304.0	-304.0
chrX	30660955	30664342	30660932	30664390	JUNC00001418	1	+	23	48	-304.0	-304.0	-304.0
chrX	30665584	30668011	30665513	30668086	JUNC00001419	40	+	71	75	-304.0	-304.0	-304.0
chrX	30665584	30677374	30665565	30677431	JUNC00001420	1	+	19	57	-304.0	-304.0	-304.0
chrX	30677452	30691122	30677421	30691155	JUNC00001421	1	+	31	33	-304.0	-304.0	-304.0
chrX	30684601	30723330	30684584	30723389	JUNC00001422	1	+	17	59	-304.0	-304.0	-304.0
chrX	30691199	30694399	30691126	30694470	JUNC00001423	26	+	73	71	-304.0	-304.0	-304.0
chrX	30694537	30696041	30694467	30696115	JUNC00001424	38	+	70	74	-304.0	-304.0	-304.0
chrX	30696151	30696616	30696076	30696683	JUNC00001425	40	+	75	67	-304.0	-304.0	-304.0
chrX	30696683	30700413	30696616	30700449	JUNC00001426	51	+	67	36	-304.0	-304.0	-304.0
chrX	30700449	30700837	30700380	30700903	JUNC00001427	45	+	69	66	-304.0	-304.0	-304.0
chrX	30700905	30707555	30700843	30707598	JUNC00001428	30	+	62	43	-304.0	-304.0	-304.0
chrX	30707598	30708053	30707555	30708126	JUNC00001429	46	+	43	73	-304.0	-304.0	-304.0
chrX	30708134	30718537	30708059	30718610	JUNC00001430	46	+	75	73	-304.0	-304.0	-304.0
chrX	30711646	30718537	30711588	30718555	JUNC00001431	1	+	58	18	-304.0	-304.0	-304.0
chrX	30718616	30719418	30718541	30719493	JUNC00001432	39	+	75	75	-304.0	-304.0	-304.0
chrX	30719515	30720010	30719440	30720085	JUNC00001433	45	+	75	75	-304.0	-304.0	-304.0
chrX	30720095	30720620	30720020	30720693	JUNC00001434	51	+	75	73	-304.0	-304.0	-304.0
chrX	30720095	30720671	30720036	30720741	JUNC00001435	4	+	59	70	-304.0	-304.0	-304.0
chrX	30720741	30720851	30720666	30720926	JUNC00001436	63	+	75	75	-304.0	-304.0	-304.0
chrX	30720995	30724100	30720924	30724174	JUNC00001437	61	+	71	74	-304.0	-304.0	-304.0
chrX	30724178	30727465	30724151	30727514	JUNC00001440	1	+	27	49	-304.0	-304.0	-304.0
chrX	30724181	30727465	30724106	30727538	JUNC00001439	26	+	75	73	-304.0	-304.0	-304.0
chrX	30724181	30728731	30724106	30728804	JUNC00001438	20	+	75	73	-304.0	-304.0	-304.0
chrX	30727552	30728731	30727478	30728805	JUNC00001441	22	+	74	74	-304.0	-304.0	-304.0
chrX	30831575	30832848	30831540	30832889	JUNC00001444	1	-	35	41	-304.0	-304.0	-304.0
chrX	30831575	30834050	30831504	30834124	JUNC00001442	37	-	71	74	-304.0	-304.0	-304.0
chrX	30831575	30842965	30831513	30843023	JUNC00001443	3	-	62	58	-304.0	-304.0	-304.0
chrX	30834152	30842965	30834081	30843034	JUNC00001446	26	-	71	69	-304.0	-304.0	-304.0
chrX	30834152	30846550	30834080	30846618	JUNC00001445	8	-	72	68	-304.0	-304.0	-304.0
chrX	30836835	30842965	30836808	30843039	JUNC00001447	2	-	27	74	-304.0	-304.0	-304.0
chrX	30843049	30845932	30843033	30845992	JUNC00001449	1	-	16	60	-304.0	-304.0	-304.0
chrX	30843049	30846550	30842978	30846614	JUNC00001448	14	-	71	64	-304.0	-304.0	-304.0
chrX	30846644	30852777	30846570	30852851	JUNC00001450	36	-	74	74	-304.0	-304.0	-304.0
chrX	30852938	30854115	30852868	30854182	JUNC00001451	19	-	70	67	-304.0	-304.0	-304.0
chrX	30854286	30859486	30854232	30859508	JUNC00001452	1	-	54	22	-304.0	-304.0	-304.0
chrX	30855419	30859486	30855362	30859505	JUNC00001453	1	-	57	19	-304.0	-304.0	-304.0
chrX	30855562	30859486	30855505	30859559	JUNC00001454	24	-	57	73	-304.0	-304.0	-304.0
chrX	30855932	30859486	30855875	30859505	JUNC00001455	1	-	57	19	-304.0	-304.0	-304.0
chrX	30859678	30867114	30859604	30867182	JUNC00001456	40	-	74	68	-304.0	-304.0	-304.0
chrX	30867218	30867464	30867143	30867532	JUNC00001457	22	-	75	68	-304.0	-304.0	-304.0
chrX	30867218	30871698	30867143	30871724	JUNC00001458	3	-	75	26	-304.0	-304.0	-304.0
chrX	30867549	30871698	30867484	30871766	JUNC00001459	21	-	65	68	-304.0	-304.0	-304.0
chrX	30871801	30889113	30871729	30889134	JUNC00001460	6	-	72	21	-304.0	-304.0	-304.0
chrX	31121930	31126641	31121859	31126675	JUNC00001462	48	-	71	34	-304.0	-304.0	-304.0
chrX	31121930	31134101	31121859	31134176	JUNC00001461	34	-	71	75	-304.0	-304.0	-304.0
chrX	31126673	31134101	31126640	31134176	JUNC00001463	43	-	33	75	-304.0	-304.0	-304.0
chrX	31134194	31146290	31134124	31146365	JUNC00001464	66	-	70	75	-304.0	-304.0	-304.0
chrX	31146414	31147274	31146342	31147349	JUNC00001465	67	-	72	75	-304.0	-304.0	-304.0
chrX	31147518	31169442	31147443	31169514	JUNC00001466	74	-	75	72	-304.0	-304.0	-304.0
chrX	31147518	31177931	31147496	31177985	JUNC00001467	1	-	22	54	-304.0	-304.0	-304.0
chrX	31169601	31172347	31169526	31172416	JUNC00001468	56	-	75	69	-304.0	-304.0	-304.0
chrX	31169601	31173538	31169572	31173585	JUNC00001469	1	-	29	47	-304.0	-304.0	-304.0
chrX	31172413	31173538	31172347	31173604	JUNC00001470	56	-	66	66	-304.0	-304.0	-304.0
chrX	31172413	31178668	31172347	31178743	JUNC00001471	4	-	66	75	-304.0	-304.0	-304.0
chrX	31173604	31177931	31173537	31177998	JUNC00001472	43	-	67	67	-304.0	-304.0	-304.0
chrX	31173604	31178668	31173538	31178743	JUNC00001473	20	-	66	75	-304.0	-304.0	-304.0
chrX	31177970	31178668	31177931	31178739	JUNC00001474	22	-	39	71	-304.0	-304.0	-304.0
chrX	31178805	31180369	31178730	31180443	JUNC00001475	49	-	75	74	-304.0	-304.0	-304.0
chrX	31180481	31182737	31180409	31182812	JUNC00001476	41	-	72	75	-304.0	-304.0	-304.0
chrX	31182904	31203960	31182832	31204033	JUNC00001477	50	-	72	73	-304.0	-304.0	-304.0
chrX	31204118	31206581	31204045	31206656	JUNC00001478	33	-	73	75	-304.0	-304.0	-304.0
chrX	31206667	31209497	31206593	31209571	JUNC00001479	49	-	74	74	-304.0	-304.0	-304.0
chrX	31209699	31210315	31209660	31210351	JUNC00001481	1	-	39	36	-304.0	-304.0	-304.0
chrX	31209699	31223046	31209627	31223114	JUNC00001480	54	-	72	68	-304.0	-304.0	-304.0
chrX	31223121	31260954	31223046	31261016	JUNC00001482	53	-	75	62	-304.0	-304.0	-304.0
chrX	31240195	31260954	31240148	31260983	JUNC00001484	1	-	47	29	-304.0	-304.0	-304.0
chrX	31249480	31256011	31249454	31256061	JUNC00001485	1	+	26	50	-304.0	-304.0	-304.0
chrX	31261016	31266809	31260954	31266884	JUNC00001483	47	-	62	75	-304.0	-304.0	-304.0
chrX	33113292	33155551	33113258	33155593	JUNC00001486	1	+	34	42	108.0	112.0	112.0
chrX	35522144	35527870	35522119	35527921	JUNC00001487	1	-	25	51	-304.0	-304.0	-304.0
chrX	37780122	37782087	37780048	37782162	JUNC00001488	109	+	74	75	-304.0	-304.0	-304.0
chrX	37782183	37783489	37782108	37783564	JUNC00001489	110	+	75	75	-304.0	-304.0	-304.0
chrX	37783600	37791974	37783525	37792049	JUNC00001490	136	+	75	75	-304.0	-304.0	-304.0
chrX	37792059	37793664	37791984	37793737	JUNC00001491	104	+	75	73	-304.0	-304.0	-304.0
chrX	37792059	37795950	37792013	37795980	JUNC00001492	1	+	46	30	-304.0	-304.0	-304.0
chrX	37793810	37795950	37793737	37796025	JUNC00001493	122	+	73	75	-304.0	-304.0	-304.0
chrX	37796141	37798954	37796066	37799029	JUNC00001494	157	+	75	75	-304.0	-304.0	-304.0
chrX	37799084	37801255	37799009	37801329	JUNC00001495	124	+	75	74	-304.0	-304.0	-304.0
chrX	37801348	37803876	37801274	37803948	JUNC00001496	97	+	74	72	-304.0	-304.0	-304.0
chrX	37801348	37805005	37801327	37805060	JUNC00001497	1	+	21	55	-304.0	-304.0	-304.0
chrX	37804130	37805005	37804055	37805080	JUNC00001498	180	+	75	75	-304.0	-304.0	-304.0
chrX	37805168	37806386	37805093	37806461	JUNC00001499	203	+	75	75	-304.0	-304.0	-304.0
chrX	37806533	37809566	37806459	37809641	JUNC00001500	215	+	74	75	-304.0	-304.0	-304.0
chrX	37809691	37810790	37809617	37810855	JUNC00001501	158	+	74	65	-304.0	-304.0	-304.0
chrX	37818542	37831376	37818513	37831423	JUNC00001502	1	+	29	47	-304.0	-304.0	-304.0
chrX	37840651	37841027	37840576	37841099	JUNC00001503	36	-	75	72	-304.0	-304.0	-304.0
chrX	37841105	37841781	37841030	37841855	JUNC00001504	35	-	75	74	-304.0	-304.0	-304.0
chrX	37841905	37846316	37841833	37846361	JUNC00001505	45	-	72	45	-304.0	-304.0	-304.0
chrX	37846358	37847480	37846316	37847545	JUNC00001506	30	-	42	65	-304.0	-304.0	-304.0
chrX	38106771	38108599	38106717	38108621	JUNC00001507	1	+	54	22	-304.0	-304.0	-304.0
chrX	38161054	38164768	38160999	38164800	JUNC00001508	2	-	55	32	-304.0	-304.0	-304.0
chrX	38257039	38273385	38257003	38273425	JUNC00001509	2	-	36	40	-304.0	-304.0	-304.0
chrX	38269832	38273385	38269768	38273460	JUNC00001510	15	-	64	75	-304.0	-304.0	-304.0
chrX	38273477	38275088	38273403	38275143	JUNC00001511	9	-	74	55	-304.0	-304.0	-304.0
chrX	38273477	38276586	38273403	38276645	JUNC00001512	3	-	74	59	-304.0	-304.0	-304.0
chrX	38275146	38276586	38275089	38276652	JUNC00001513	10	-	57	66	-304.0	-304.0	-304.0
chrX	38276772	38277853	38276699	38277880	JUNC00001515	2	-	73	27	-304.0	-304.0	-304.0
chrX	38276772	38287093	38276702	38287168	JUNC00001516	6	-	70	75	-304.0	-304.0	-304.0
chrX	38276772	38290958	38276699	38291009	JUNC00001514	6	-	73	51	-304.0	-304.0	-304.0
chrX	38287245	38287860	38287184	38287933	JUNC00001517	13	-	61	73	-304.0	-304.0	-304.0
chrX	38288041	38290958	38287968	38291018	JUNC00001518	5	-	73	60	-304.0	-304.0	-304.0
chrX	38291024	38291392	38290958	38291454	JUNC00001519	7	-	66	62	-304.0	-304.0	-304.0
chrX	38291484	38297283	38291422	38297358	JUNC00001520	11	-	62	75	-304.0	-304.0	-304.0
chrX	38297452	38298955	38297398	38298977	JUNC00001521	1	-	54	22	-304.0	-304.0	-304.0
chrX	38299141	38301246	38299066	38301301	JUNC00001522	2	-	75	55	-304.0	-304.0	-304.0
chrX	38301371	38304634	38301298	38304683	JUNC00001523	6	-	73	49	-304.0	-304.0	-304.0
chrX	38301371	38310614	38301349	38310668	JUNC00001524	1	-	22	54	-304.0	-304.0	-304.0
chrX	38304790	38310614	38304738	38310677	JUNC00001525	3	-	52	63	-304.0	-304.0	-304.0
chrX	38310773	38317315	38310705	38317385	JUNC00001526	5	-	68	70	-304.0	-304.0	-304.0
chrX	38317465	38318828	38317406	38318901	JUNC00001527	7	-	59	73	-304.0	-304.0	-304.0
chrX	38318987	38321026	38318914	38321087	JUNC00001528	5	-	73	61	-304.0	-304.0	-304.0
chrX	38321089	38322852	38321043	38322895	JUNC00001529	2	-	46	43	-304.0	-304.0	-304.0
chrX	38322945	38323398	38322910	38323450	JUNC00001530	3	-	35	52	-304.0	-304.0	-304.0
chrX	38323524	38327339	38323485	38327376	JUNC00001531	1	-	39	37	-304.0	-304.0	-304.0
chrX	38472327	38498331	38472312	38498392	JUNC00001532	1	-	15	61	-304.0	-304.0	-304.0
chrX	38671450	38674220	38671400	38674291	JUNC00001533	4	+	50	71	-304.0	-304.0	-304.0
chrX	38674316	38675704	38674264	38675749	JUNC00001534	3	+	52	45	-304.0	-304.0	-304.0
chrX	38675860	38681203	38675830	38681249	JUNC00001535	1	+	30	46	-304.0	-304.0	-304.0
chrX	38681287	38687598	38681225	38687662	JUNC00001536	3	+	62	64	-304.0	-304.0	-304.0
chrX	38687674	38687938	38687614	38687987	JUNC00001537	2	+	60	49	-304.0	-304.0	-304.0
chrX	38801487	38802534	38801467	38802590	JUNC00001538	1	+	20	56	-304.0	-304.0	-304.0
chrX	38801792	38803732	38801773	38803789	JUNC00001539	1	-	19	57	-304.0	-304.0	-304.0
chrX	38804413	38804682	38804338	38804757	JUNC00001540	146	+	75	75	-304.0	-304.0	-304.0
chrX	38820518	39019228	38820472	39019284	JUNC00001542	2	+	46	56	-304.0	-304.0	-304.0
chrX	38820518	39131810	38820467	39131835	JUNC00001541	1	+	51	25	-304.0	-304.0	-304.0
chrX	39214130	39299362	39214068	39299400	JUNC00001543	2	-	62	38	-304.0	-304.0	-304.0
chrX	39262648	39262880	39262631	39262939	JUNC00001544	1	-	17	59	-304.0	-304.0	-304.0
chrX	39299532	39299722	39299491	39299770	JUNC00001545	2	-	41	48	-304.0	-304.0	-304.0
chrX	39768748	39794961	39768728	39795017	JUNC00001546	1	+	20	56	-304.0	128.0	128.0
chrX	39849892	39855635	39849842	39855674	JUNC00001547	3	-	50	39	-304.0	-304.0	-304.0
chrX	39905056	39906435	39905035	39906490	JUNC00001548	1	+	21	55	-304.0	-304.0	-304.0
chrX	39943148	39977883	39943113	39977925	JUNC00001549	2	+	35	42	-304.0	-304.0	-304.0
chrX	40016933	40022524	40016915	40022582	JUNC00001550	1	-	18	58	-304.0	-304.0	-304.0
chrX	40052400	40053837	40052373	40053885	JUNC00001552	1	-	27	48	-304.0	-304.0	-304.0
chrX	40052400	40053885	40052330	40053955	JUNC00001551	30	-	70	70	-304.0	-304.0	-304.0
chrX	40054042	40054255	40053970	40054330	JUNC00001553	36	-	72	75	-304.0	-304.0	-304.0
chrX	40054333	40055367	40054259	40055441	JUNC00001554	28	-	74	74	-304.0	-304.0	-304.0
chrX	40055513	40057154	40055438	40057229	JUNC00001555	40	-	75	75	-304.0	-304.0	-304.0
chrX	40057321	40062138	40057248	40062207	JUNC00001556	28	-	73	69	-304.0	-304.0	-304.0
chrX	40062393	40062745	40062323	40062816	JUNC00001557	58	-	70	71	-304.0	-304.0	-304.0
chrX	40063071	40063607	40063000	40063680	JUNC00001558	29	-	71	73	-304.0	-304.0	-304.0
chrX	40063850	40064335	40063778	40064410	JUNC00001559	24	-	72	75	-304.0	-304.0	-304.0
chrX	40063952	40064335	40063912	40064371	JUNC00001560	1	-	40	36	-304.0	-304.0	-304.0
chrX	40064599	40070972	40064524	40071045	JUNC00001561	46	-	75	73	-304.0	-304.0	-304.0
chrX	40071159	40071636	40071084	40071692	JUNC00001562	41	-	75	56	-304.0	-304.0	-304.0
chrX	40071159	40072348	40071084	40072419	JUNC00001563	12	-	75	71	-304.0	-304.0	-304.0
chrX	40071690	40072348	40071636	40072420	JUNC00001564	32	-	54	72	-304.0	-304.0	-304.0
chrX	40074313	40074537	40074282	40074582	JUNC00001565	1	+	31	45	-304.0	-304.0	-304.0
chrX	40075180	40076453	40075107	40076518	JUNC00001566	40	-	73	65	-304.0	-304.0	-304.0
chrX	40076532	40077843	40076457	40077918	JUNC00001567	41	-	75	75	-304.0	-304.0	-304.0
chrX	40077969	40095795	40077923	40095825	JUNC00001570	1	-	46	30	-304.0	-304.0	-304.0
chrX	40077969	40096459	40077927	40096493	JUNC00001571	1	-	42	34	-304.0	-304.0	-304.0
chrX	40077969	40097214	40077898	40097288	JUNC00001568	26	-	71	74	-304.0	-304.0	-304.0
chrX	40077969	40177006	40077919	40177057	JUNC00001569	4	-	50	51	-304.0	-304.0	-304.0
chrX	40560423	40657873	40560402	40657928	JUNC00001572	1	-	21	55	122.0	112.0	122.0
chrX	40574267	40657873	40574246	40657928	JUNC00001573	1	-	21	55	-304.0	-304.0	-304.0
chrX	40579747	40588985	40579705	40589045	JUNC00001574	2	+	42	60	-304.0	-304.0	-304.0
chrX	40581102	40588985	40581036	40589060	JUNC00001575	67	+	66	75	-304.0	-304.0	-304.0
chrX	40581102	40591233	40581049	40591306	JUNC00001576	3	+	53	73	-304.0	-304.0	-304.0
chrX	40589116	40591233	40589041	40591308	JUNC00001577	294	+	75	75	-304.0	-304.0	-304.0
chrX	40589116	40597248	40589073	40597281	JUNC00001578	1	+	43	33	-304.0	-304.0	-304.0
chrX	40591365	40597248	40591290	40597323	JUNC00001579	294	+	75	75	-304.0	-304.0	-304.0
chrX	40591365	40598680	40591313	40598734	JUNC00001580	5	+	52	54	-304.0	-304.0	-304.0
chrX	40597344	40597526	40597269	40597601	JUNC00001582	278	+	75	75	-304.0	-304.0	-304.0
chrX	40597664	40598680	40597589	40598738	JUNC00001583	362	+	75	58	-304.0	-304.0	-304.0
chrX	40598734	40599591	40598680	40599663	JUNC00001581	346	+	54	72	-304.0	-304.0	-304.0
chrX	40599741	40600761	40599666	40600836	JUNC00001584	283	+	75	75	-304.0	-304.0	-304.0
chrX	40599741	40600768	40599691	40600794	JUNC00001585	1	+	50	26	-304.0	-304.0	-304.0
chrX	40600881	40605560	40600806	40605635	JUNC00001587	285	+	75	75	-304.0	-304.0	-304.0
chrX	40600881	40605563	40600806	40605638	JUNC00001586	5	+	75	75	-304.0	-304.0	-304.0
chrX	40630162	40630613	40630090	40630688	JUNC00001588	65	-	72	75	-304.0	-304.0	-304.0
chrX	40630773	40636532	40630700	40636606	JUNC00001589	60	-	73	74	-304.0	-304.0	-304.0
chrX	40636712	40637006	40636638	40637080	JUNC00001590	120	-	74	74	-304.0	-304.0	-304.0
chrX	40637156	40639008	40637085	40639078	JUNC00001591	95	-	71	70	-304.0	-304.0	-304.0
chrX	40639128	40647006	40639053	40647079	JUNC00001592	35	-	75	73	-304.0	-304.0	-304.0
chrX	40645922	40646246	40645882	40646282	JUNC00001593	1	?	40	36	-304.0	-304.0	-304.0
chrX	40647141	40647304	40647079	40647356	JUNC00001594	4	-	62	52	-304.0	-304.0	-304.0
chrX	40649672	40654363	40649633	40654400	JUNC00001595	1	-	39	37	-304.0	-304.0	-304.0
chrX	40651879	40654363	40651804	40654438	JUNC00001596	118	-	75	75	-304.0	-304.0	-304.0
chrX	40654556	40654934	40654484	40655006	JUNC00001597	86	-	72	72	-304.0	-304.0	-304.0
chrX	40655060	40659226	40654985	40659300	JUNC00001598	105	-	75	74	-304.0	-304.0	-304.0
chrX	40659334	40659427	40659269	40659499	JUNC00001599	81	-	65	72	-304.0	-304.0	-304.0
chrX	40659601	40662924	40659542	40662941	JUNC00001601	1	-	59	17	-304.0	-304.0	-304.0
chrX	40659607	40662924	40659532	40662999	JUNC00001600	118	-	75	75	-304.0	-304.0	-304.0
chrX	40663160	40664306	40663087	40664381	JUNC00001602	171	-	73	75	-304.0	-304.0	-304.0
chrX	40664489	40666719	40664414	40666793	JUNC00001603	83	-	75	74	-304.0	-304.0	-304.0
chrX	40664489	40671860	40664414	40671935	JUNC00001604	14	-	75	75	-304.0	-304.0	-304.0
chrX	40666851	40671860	40666776	40671935	JUNC00001605	120	-	75	75	-304.0	-304.0	-304.0
chrX	40671972	40675220	40671897	40675292	JUNC00001606	99	-	75	72	-304.0	-304.0	-304.0
chrX	40675361	40679863	40675287	40679937	JUNC00001607	115	-	74	74	-304.0	-304.0	-304.0
chrX	40680133	40680757	40680058	40680830	JUNC00001608	104	-	75	73	-304.0	-304.0	-304.0
chrX	40680910	40681851	40680837	40681926	JUNC00001609	99	-	73	75	-304.0	-304.0	-304.0
chrX	40681943	40682602	40681869	40682676	JUNC00001610	82	-	74	74	-304.0	-304.0	-304.0
chrX	40682749	40682835	40682674	40682910	JUNC00001611	118	-	75	75	-304.0	-304.0	-304.0
chrX	40682996	40688453	40682921	40688528	JUNC00001612	66	-	75	75	-304.0	-304.0	-304.0
chrX	40688530	40692182	40688455	40692255	JUNC00001613	63	-	75	73	-304.0	-304.0	-304.0
chrX	40692317	40692707	40692243	40692782	JUNC00001614	119	-	74	75	-304.0	-304.0	-304.0
chrX	40692902	40697023	40692830	40697095	JUNC00001615	77	-	72	72	-304.0	-304.0	-304.0
chrX	40697183	40701164	40697110	40701238	JUNC00001616	88	-	73	74	-304.0	-304.0	-304.0
chrX	40701243	40703443	40701169	40703518	JUNC00001617	91	-	74	75	-304.0	-304.0	-304.0
chrX	40703569	40709347	40703498	40709420	JUNC00001618	112	-	71	73	-304.0	-304.0	-304.0
chrX	40709459	40709978	40709384	40710052	JUNC00001619	86	-	75	74	-304.0	-304.0	-304.0
chrX	40710129	40711168	40710054	40711243	JUNC00001620	62	-	75	75	-304.0	-304.0	-304.0
chrX	40711301	40712185	40711226	40712260	JUNC00001621	84	-	75	75	-304.0	-304.0	-304.0
chrX	40712293	40712913	40712218	40712985	JUNC00001622	92	-	75	72	-304.0	-304.0	-304.0
chrX	40713042	40713777	40712968	40713848	JUNC00001623	90	-	74	71	-304.0	-304.0	-304.0
chrX	40713907	40714536	40713835	40714611	JUNC00001624	77	-	72	75	-304.0	-304.0	-304.0
chrX	40714710	40726745	40714640	40726820	JUNC00001625	48	-	70	75	-304.0	-304.0	-304.0
chrX	40726851	40729318	40726776	40729347	JUNC00001626	54	-	75	29	-304.0	-304.0	-304.0
chrX	40726869	40729318	40726829	40729345	JUNC00001630	1	-	40	27	-304.0	-304.0	-304.0
chrX	40729345	40730244	40729318	40730262	JUNC00001628	2	-	27	18	-304.0	-304.0	-304.0
chrX	40729345	40735197	40729318	40735272	JUNC00001627	34	-	27	75	-304.0	-304.0	-304.0
chrX	40729345	40735721	40729318	40735773	JUNC00001629	3	-	27	52	-304.0	-304.0	-304.0
chrX	40735790	40738192	40735728	40738259	JUNC00001631	4	+	62	67	-304.0	-304.0	-304.0
chrX	40897005	40995954	40896987	40996010	JUNC00001632	1	+	18	56	-304.0	-304.0	-304.0
chrX	41070224	41135725	41070200	41135772	JUNC00001633	1	+	24	47	120.0	-304.0	120.0
chrX	41075074	41132385	41075025	41132412	JUNC00001634	1	-	49	27	120.0	120.0	120.0
chrX	41086109	41094221	41086061	41094249	JUNC00001636	1	+	48	28	-304.0	-304.0	-304.0
chrX	41086109	41123470	41086037	41123545	JUNC00001635	55	+	72	75	-304.0	-304.0	-304.0
chrX	41087665	41123470	41087635	41123516	JUNC00001637	1	+	30	46	-304.0	-304.0	-304.0
chrX	41114761	41123470	41114734	41123519	JUNC00001638	1	+	27	49	-304.0	-304.0	-304.0
chrX	41123724	41128999	41123650	41129074	JUNC00001639	102	+	74	75	-304.0	-304.0	-304.0
chrX	41129145	41131456	41129070	41131528	JUNC00001640	84	+	75	72	-304.0	-304.0	-304.0
chrX	41131536	41134724	41131462	41134799	JUNC00001641	59	+	74	75	-304.0	-304.0	-304.0
chrX	41134837	41136803	41134767	41136876	JUNC00001642	62	+	70	73	-304.0	-304.0	-304.0
chrX	41137022	41140655	41136949	41140727	JUNC00001643	84	+	73	72	-304.0	-304.0	-304.0
chrX	41140771	41140965	41140697	41141040	JUNC00001644	85	+	74	75	-304.0	-304.0	-304.0
chrX	41141217	41141292	41141142	41141364	JUNC00001645	47	+	75	72	-304.0	-304.0	-304.0
chrX	41141431	41143290	41141357	41143365	JUNC00001646	90	+	74	75	-304.0	-304.0	-304.0
chrX	41141431	41144521	41141409	41144575	JUNC00001647	1	+	22	54	-304.0	-304.0	-304.0
chrX	41143443	41144521	41143368	41144596	JUNC00001648	118	+	75	75	-304.0	-304.0	-304.0
chrX	41144626	41148368	41144553	41148440	JUNC00001649	103	+	73	72	-304.0	-304.0	-304.0
chrX	41148575	41150920	41148500	41150992	JUNC00001650	71	+	75	72	-304.0	-304.0	-304.0
chrX	41151057	41152932	41150982	41153006	JUNC00001651	31	+	75	74	-304.0	-304.0	-304.0
chrX	41151057	41152947	41150982	41153022	JUNC00001652	64	+	75	75	-304.0	-304.0	-304.0
chrX	41153081	41162789	41153009	41162864	JUNC00001653	116	+	72	75	-304.0	-304.0	-304.0
chrX	41162877	41165871	41162803	41165946	JUNC00001654	97	+	74	75	-304.0	-304.0	-304.0
chrX	41166214	41167481	41166139	41167556	JUNC00001655	102	+	75	75	-304.0	-304.0	-304.0
chrX	41167577	41168006	41167502	41168081	JUNC00001656	101	+	75	75	-304.0	-304.0	-304.0
chrX	41168218	41169994	41168143	41170069	JUNC00001657	116	+	75	75	-304.0	-304.0	-304.0
chrX	41170235	41170469	41170162	41170544	JUNC00001658	122	+	73	75	-304.0	-304.0	-304.0
chrX	41170619	41171837	41170545	41171912	JUNC00001659	126	+	74	75	-304.0	-304.0	-304.0
chrX	41171958	41183997	41171884	41184072	JUNC00001660	113	+	74	75	-304.0	-304.0	-304.0
chrX	41171958	41184535	41171926	41184608	JUNC00001661	2	+	32	73	-304.0	-304.0	-304.0
chrX	41184128	41184396	41184053	41184469	JUNC00001662	96	+	75	73	-304.0	-304.0	-304.0
chrX	41184675	41186516	41184602	41186591	JUNC00001663	192	+	73	75	-304.0	-304.0	-304.0
chrX	41186642	41187991	41186567	41188064	JUNC00001664	88	+	75	73	-304.0	-304.0	-304.0
chrX	41188117	41189308	41188043	41189383	JUNC00001665	85	+	74	75	-304.0	-304.0	-304.0
chrX	41189475	41196250	41189401	41196325	JUNC00001666	122	+	74	75	-304.0	-304.0	-304.0
chrX	41196359	41196591	41196284	41196666	JUNC00001667	111	+	75	75	-304.0	-304.0	-304.0
chrX	41196738	41197363	41196663	41197438	JUNC00001668	134	+	75	75	-304.0	-304.0	-304.0
chrX	41197510	41198527	41197437	41198601	JUNC00001669	89	+	73	74	-304.0	-304.0	-304.0
chrX	41198750	41201059	41198677	41201131	JUNC00001670	113	+	73	72	-304.0	-304.0	-304.0
chrX	41201280	41205302	41201205	41205377	JUNC00001671	198	+	75	75	-304.0	-304.0	-304.0
chrX	41203933	41207320	41203904	41207367	JUNC00001672	1	+	29	47	-304.0	-304.0	-304.0
chrX	41205493	41210508	41205419	41210583	JUNC00001673	108	+	74	75	-304.0	-304.0	-304.0
chrX	41205493	41214567	41205442	41214592	JUNC00001674	1	+	51	25	-304.0	-304.0	-304.0
chrX	41210682	41214567	41210607	41214642	JUNC00001675	109	+	75	75	-304.0	-304.0	-304.0
chrX	41214709	41215898	41214635	41215973	JUNC00001676	118	+	74	75	-304.0	-304.0	-304.0
chrX	41216058	41217219	41216037	41217274	JUNC00001677	1	+	21	55	-304.0	-304.0	-304.0
chrX	41216198	41216237	41216167	41216282	JUNC00001678	1	?	31	45	-304.0	-304.0	-304.0
chrX	41216652	41217219	41216577	41217294	JUNC00001679	106	+	75	75	-304.0	-304.0	-304.0
chrX	41217343	41218371	41217269	41218443	JUNC00001680	145	+	74	72	-304.0	-304.0	-304.0
chrX	41218597	41219101	41218522	41219176	JUNC00001681	137	+	75	75	-304.0	-304.0	-304.0
chrX	41219231	41223216	41219156	41223289	JUNC00001682	157	+	75	73	-304.0	-304.0	-304.0
chrX	41223402	41224741	41223327	41224816	JUNC00001683	209	+	75	75	-304.0	-304.0	-304.0
chrX	41224962	41225048	41224887	41225123	JUNC00001684	162	+	75	75	-304.0	-304.0	-304.0
chrX	41225137	41229252	41225062	41229326	JUNC00001685	196	+	75	74	-304.0	-304.0	-304.0
chrX	41229409	41229566	41229334	41229641	JUNC00001686	165	+	75	75	-304.0	-304.0	-304.0
chrX	41229779	41230500	41229704	41230575	JUNC00001687	200	+	75	75	-304.0	-304.0	-304.0
chrX	41229827	41230500	41229759	41230572	JUNC00001688	15	+	68	72	-304.0	-304.0	-304.0
chrX	41230596	41232386	41230521	41232461	JUNC00001689	223	+	75	75	-304.0	-304.0	-304.0
chrX	41274820	41282065	41274796	41282117	JUNC00001690	1	-	24	52	-304.0	-304.0	-304.0
chrX	41279123	41282065	41279099	41282117	JUNC00001691	1	-	24	52	-304.0	-304.0	-304.0
chrX	41329596	41390296	41329563	41390339	JUNC00001692	2	-	33	43	-304.0	-304.0	-304.0
chrX	41334297	41337407	41334222	41337479	JUNC00001693	342	+	75	72	-304.0	-304.0	-304.0
chrX	41334297	41341483	41334269	41341557	JUNC00001694	3	+	28	74	-304.0	-304.0	-304.0
chrX	41337465	41337690	41337406	41337753	JUNC00001697	4	+	59	63	-304.0	-304.0	-304.0
chrX	41337465	41339035	41337405	41339085	JUNC00001695	384	+	60	50	-304.0	-304.0	-304.0
chrX	41337465	41339038	41337407	41339083	JUNC00001696	5	+	58	45	-304.0	-304.0	-304.0
chrX	41337465	41341483	41337426	41341520	JUNC00001699	1	+	39	37	-304.0	-304.0	-304.0
chrX	41337465	41342494	41337416	41342521	JUNC00001698	1	+	49	27	-304.0	-304.0	-304.0
chrX	41339083	41340635	41339035	41340674	JUNC00001701	10	+	48	39	-304.0	-304.0	-304.0
chrX	41339083	41341483	41339035	41341558	JUNC00001700	431	+	48	75	-304.0	-304.0	-304.0
chrX	41340022	41341067	41340003	41341124	JUNC00001702	1	-	19	57	-304.0	-304.0	-304.0
chrX	41340814	41341483	41340757	41341558	JUNC00001703	5	+	57	75	-304.0	-304.0	-304.0
chrX	41341616	41342494	41341541	41342569	JUNC00001704	491	+	75	75	-304.0	-304.0	-304.0
chrX	41342653	41342736	41342578	41342811	JUNC00001705	460	+	75	75	-304.0	-304.0	-304.0
chrX	41342836	41343215	41342761	41343290	JUNC00001706	386	+	75	75	-304.0	-304.0	-304.0
chrX	41343351	41343736	41343276	41343811	JUNC00001707	281	+	75	75	-304.0	-304.0	-304.0
chrX	41343822	41344029	41343747	41344104	JUNC00001708	343	+	75	75	-304.0	-304.0	-304.0
chrX	41344128	41344238	41344053	41344313	JUNC00001709	487	+	75	75	-304.0	-304.0	-304.0
chrX	41344399	41345179	41344324	41345253	JUNC00001710	363	+	75	74	-304.0	-304.0	-304.0
chrX	41344564	41345179	41344539	41345230	JUNC00001711	1	+	25	51	-304.0	-304.0	-304.0
chrX	41345324	41345403	41345249	41345478	JUNC00001712	305	+	75	75	-304.0	-304.0	-304.0
chrX	41345548	41346228	41345474	41346303	JUNC00001713	392	+	74	75	-304.0	-304.0	-304.0
chrX	41346410	41346504	41346335	41346579	JUNC00001714	395	+	75	75	-304.0	-304.0	-304.0
chrX	41346622	41346858	41346547	41346933	JUNC00001715	376	+	75	75	-304.0	-304.0	-304.0
chrX	41347012	41347311	41346937	41347386	JUNC00001716	212	+	75	75	-304.0	-304.0	-304.0
chrX	41347012	41347314	41346939	41347389	JUNC00001717	109	+	73	75	-304.0	-304.0	-304.0
chrX	41347012	41347317	41346994	41347372	JUNC00001718	1	+	18	55	-304.0	-304.0	-304.0
chrX	41347451	41347639	41347376	41347714	JUNC00001719	219	+	75	75	-304.0	-304.0	-304.0
chrX	41347915	41357832	41347842	41357833	JUNC00001720	2	+	73	1	-304.0	-304.0	-304.0
chrX	41417903	41423164	41417883	41423220	JUNC00001721	1	+	20	56	-304.0	-304.0	-304.0
chrX	41433118	41445140	41433064	41445162	JUNC00001722	1	-	54	22	-304.0	-304.0	-304.0
chrX	41486519	41503765	41486483	41503805	JUNC00001723	1	-	36	40	-304.0	-304.0	-304.0
chrX	41520596	41523950	41520522	41524013	JUNC00001724	25	-	74	63	-304.0	-304.0	-304.0
chrX	41524034	41529528	41523989	41529559	JUNC00001726	1	-	45	31	-304.0	-304.0	-304.0
chrX	41524034	41531006	41523961	41531081	JUNC00001725	32	-	73	75	-304.0	-304.0	-304.0
chrX	41531209	41534705	41531140	41534779	JUNC00001727	36	-	69	74	-304.0	-304.0	-304.0
chrX	41534786	41534892	41534711	41534966	JUNC00001728	27	-	75	74	-304.0	-304.0	-304.0
chrX	41534973	41542690	41534906	41542753	JUNC00001729	13	-	67	63	-304.0	-304.0	-304.0
chrX	41542806	41553718	41542739	41553788	JUNC00001730	21	-	67	70	-304.0	-304.0	-304.0
chrX	41553915	41555599	41553840	41555635	JUNC00001732	13	-	75	36	-304.0	-304.0	-304.0
chrX	41553915	41557031	41553840	41557096	JUNC00001731	10	-	75	65	-304.0	-304.0	-304.0
chrX	41553915	41559778	41553875	41559838	JUNC00001733	6	-	40	60	-304.0	-304.0	-304.0
chrX	41555635	41557031	41555599	41557093	JUNC00001734	3	-	36	62	-304.0	-304.0	-304.0
chrX	41555635	41559778	41555599	41559844	JUNC00001735	5	-	36	66	-304.0	-304.0	-304.0
chrX	41557100	41559778	41557046	41559843	JUNC00001736	20	-	54	65	-304.0	-304.0	-304.0
chrX	41559847	41561558	41559781	41561630	JUNC00001737	35	-	66	72	-304.0	-304.0	-304.0
chrX	41561644	41569667	41561573	41569741	JUNC00001738	25	-	71	74	-304.0	-304.0	-304.0
chrX	41569746	41578339	41569672	41578412	JUNC00001739	12	-	74	73	-304.0	-304.0	-304.0
chrX	41578528	41586906	41578456	41586979	JUNC00001740	32	-	72	73	-304.0	-304.0	-304.0
chrX	41586987	41589514	41586915	41589584	JUNC00001741	25	-	72	70	-304.0	-304.0	-304.0
chrX	41589592	41609903	41589520	41609961	JUNC00001742	26	-	72	58	-304.0	-304.0	-304.0
chrX	41610025	41626603	41609957	41626676	JUNC00001743	32	-	68	73	-304.0	-304.0	-304.0
chrX	41626703	41636577	41626630	41636648	JUNC00001744	24	-	73	71	-304.0	-304.0	-304.0
chrX	41636661	41660438	41636586	41660509	JUNC00001745	21	-	75	71	-304.0	-304.0	-304.0
chrX	41660561	41665276	41660486	41665338	JUNC00001746	20	-	75	62	-304.0	-304.0	-304.0
chrX	41664027	41688850	41663982	41688881	JUNC00001747	1	+	45	31	-304.0	-304.0	-304.0
chrX	41665452	41665736	41665426	41665786	JUNC00001749	1	-	26	50	-304.0	-304.0	-304.0
chrX	41665452	41671427	41665386	41671502	JUNC00001748	28	-	66	75	-304.0	-304.0	-304.0
chrX	41671530	41709113	41671513	41709172	JUNC00001751	1	-	17	59	-304.0	-304.0	-304.0
chrX	41671530	41739383	41671459	41739454	JUNC00001750	29	-	71	71	-304.0	-304.0	-304.0
chrX	41679366	41688875	41679325	41688902	JUNC00001752	1	+	41	27	-304.0	-304.0	-304.0
chrX	41689084	41689742	41689022	41689806	JUNC00001753	5	+	62	64	-304.0	-304.0	-304.0
chrX	41689835	41695554	41689766	41695629	JUNC00001754	8	+	69	75	-304.0	-304.0	-304.0
chrX	41698095	41739383	41698039	41739403	JUNC00001755	1	-	56	20	-304.0	-304.0	-304.0
chrX	41702357	41739383	41702333	41739435	JUNC00001756	1	-	24	52	-304.0	-304.0	-304.0
chrX	41724289	41726772	41724214	41726843	JUNC00001757	12	+	75	71	-304.0	-304.0	-304.0
chrX	41726843	41726992	41726769	41727043	JUNC00001758	8	+	74	51	-304.0	-304.0	-304.0
chrX	41739456	41745523	41739386	41745594	JUNC00001759	29	-	70	71	-304.0	-304.0	-304.0
chrX	41743736	41745523	41743664	41745592	JUNC00001760	7	-	72	69	-304.0	-304.0	-304.0
chrX	41745601	41787177	41745534	41787251	JUNC00001761	38	-	67	74	-304.0	-304.0	-304.0
chrX	41787283	41853114	41787212	41853189	JUNC00001762	49	-	71	75	-304.0	-304.0	-304.0
chrX	41787283	41922929	41787218	41922984	JUNC00001763	2	-	65	55	-304.0	-304.0	-304.0
chrX	41853227	41922929	41853153	41923004	JUNC00001764	34	-	74	75	-304.0	-304.0	-304.0
chrX	43823450	43857198	43823430	43857254	JUNC00001765	1	+	20	56	-304.0	-304.0	-304.0
chrX	44309912	44309953	44309883	44309999	JUNC00001766	1	-	29	46	-304.0	-304.0	-304.0
chrX	44342817	44721643	44342777	44721679	JUNC00001767	1	+	40	36	-304.0	-304.0	-304.0
chrX	44369395	44394812	44369370	44394861	JUNC00001768	1	+	25	49	116.0	-304.0	116.0
chrX	44524275	44527236	44524201	44527311	JUNC00001769	87	-	74	75	-304.0	-304.0	-304.0
chrX	44527365	44538466	44527290	44538540	JUNC00001770	59	-	75	74	-304.0	-304.0	-304.0
chrX	44538542	44541944	44538468	44542019	JUNC00001771	44	-	74	75	-304.0	-304.0	-304.0
chrX	44542101	44542804	44542030	44542871	JUNC00001772	41	-	71	67	-304.0	-304.0	-304.0
chrX	44558175	44576458	44558151	44576510	JUNC00001773	1	-	24	52	-304.0	-304.0	-304.0
chrX	44609103	44709459	44609082	44709514	JUNC00001774	1	+	21	55	114.0	-304.0	114.0
chrX	44614650	44709459	44614629	44709514	JUNC00001775	1	+	21	55	-304.0	-304.0	-304.0
chrX	44701608	44718569	44701579	44718616	JUNC00001776	1	+	29	47	-304.0	-304.0	-304.0
chrX	44741219	44741338	44741166	44741361	JUNC00001777	1	+	53	23	-304.0	-304.0	-304.0
chrX	44785506	44865061	44785467	44865098	JUNC00001778	1	-	39	37	-304.0	-304.0	-304.0
chrX	44818202	44871112	44818177	44871159	JUNC00001779	2	-	25	47	-304.0	-304.0	-304.0
chrX	44847733	44886260	44847688	44886291	JUNC00001780	1	+	45	31	-304.0	-304.0	-304.0
chrX	44873712	44873923	44873649	44873987	JUNC00001781	12	+	63	64	-304.0	-304.0	-304.0
chrX	44873987	44961283	44873922	44961353	JUNC00001782	18	+	65	70	-304.0	-304.0	-304.0
chrX	44886721	44933505	44886682	44933542	JUNC00001783	1	-	39	37	110.0	108.0	110.0
chrX	44922284	44922699	44922264	44922755	JUNC00001784	1	-	20	56	-304.0	-304.0	-304.0
chrX	44961392	44974665	44961323	44974715	JUNC00001785	27	+	69	50	-304.0	-304.0	-304.0
chrX	44972957	45043699	44972913	45043729	JUNC00001787	2	-	44	30	122.0	112.0	122.0
chrX	44974715	44976651	44974669	44976681	JUNC00001788	1	+	46	30	-304.0	-304.0	-304.0
chrX	44974715	45010960	44974664	45011019	JUNC00001786	27	+	51	59	-304.0	-304.0	-304.0
chrX	45011019	45020609	45010958	45020684	JUNC00001789	23	+	61	75	-304.0	-304.0	-304.0
chrX	45020730	45034930	45020656	45034985	JUNC00001790	15	+	74	55	-304.0	-304.0	-304.0
chrX	45034985	45037654	45034928	45037689	JUNC00001791	27	+	57	35	-304.0	-304.0	-304.0
chrX	45037689	45051708	45037614	45051783	JUNC00001792	23	+	75	75	-304.0	-304.0	-304.0
chrX	45051802	45053828	45051727	45053899	JUNC00001793	25	+	75	71	-304.0	-304.0	-304.0
chrX	45053955	45059005	45053882	45059079	JUNC00001794	37	+	73	74	-304.0	-304.0	-304.0
chrX	45059104	45059246	45059036	45059321	JUNC00001795	26	+	68	75	-304.0	-304.0	-304.0
chrX	45059466	45060021	45059419	45060070	JUNC00001797	5	+	47	49	-304.0	-304.0	-304.0
chrX	45059466	45060608	45059392	45060677	JUNC00001796	8	+	74	69	-304.0	-304.0	-304.0
chrX	45060156	45061323	45060122	45061398	JUNC00001798	2	+	34	75	-304.0	-304.0	-304.0
chrX	45060764	45061323	45060695	45061398	JUNC00001799	6	+	69	75	-304.0	-304.0	-304.0
chrX	45061419	45062646	45061360	45062699	JUNC00001801	8	+	59	53	-304.0	-304.0	-304.0
chrX	45061419	45063421	45061344	45063490	JUNC00001800	11	+	75	69	-304.0	-304.0	-304.0
chrX	45062748	45063421	45062677	45063491	JUNC00001802	19	+	71	70	-304.0	-304.0	-304.0
chrX	45063817	45069578	45063742	45069653	JUNC00001803	37	+	75	75	-304.0	-304.0	-304.0
chrX	45067795	45081075	45067756	45081105	JUNC00001804	1	+	39	30	100.0	-304.0	100.0
chrX	45070357	45076696	45070282	45076769	JUNC00001805	30	+	75	73	-304.0	-304.0	-304.0
chrX	45076826	45078399	45076752	45078470	JUNC00001806	44	+	74	71	-304.0	-304.0	-304.0
chrX	45078505	45079145	45078431	45079220	JUNC00001807	51	+	74	75	-304.0	-304.0	-304.0
chrX	45079351	45082575	45079276	45082640	JUNC00001808	37	+	75	65	-304.0	-304.0	-304.0
chrX	45082640	45082714	45082575	45082783	JUNC00001809	37	+	65	69	-304.0	-304.0	-304.0
chrX	45082789	45083459	45082714	45083531	JUNC00001810	35	+	75	72	-304.0	-304.0	-304.0
chrX	45083021	45146805	45083005	45146859	JUNC00001811	1	-	16	54	-304.0	-304.0	-304.0
chrX	45083608	45085864	45083533	45085936	JUNC00001812	33	+	75	72	-304.0	-304.0	-304.0
chrX	45085979	45089742	45085912	45089817	JUNC00001813	38	+	67	75	-304.0	-304.0	-304.0
chrX	45089930	45090722	45089861	45090794	JUNC00001814	31	+	69	72	-304.0	-304.0	-304.0
chrX	45090832	45107409	45090757	45107410	JUNC00001815	2	+	75	1	-304.0	-304.0	-304.0
chrX	45090864	45107409	45090789	45107484	JUNC00001816	34	+	75	75	-304.0	-304.0	-304.0
chrX	45106649	45107409	45106610	45107484	JUNC00001817	2	+	39	75	-304.0	-304.0	-304.0
chrX	45107536	45110078	45107464	45110151	JUNC00001818	30	+	72	73	-304.0	-304.0	-304.0
chrX	45110249	45111381	45110175	45111456	JUNC00001819	43	+	74	75	-304.0	-304.0	-304.0
chrX	46418094	46505017	46418077	46505032	JUNC00001820	1	+	17	15	-304.0	-304.0	-304.0
chrX	46426330	46505017	46426313	46505032	JUNC00001822	1	+	17	15	-304.0	-304.0	-304.0
chrX	46433501	46505017	46433484	46505032	JUNC00001823	1	+	17	15	-304.0	-304.0	-304.0
chrX	46439751	46439775	46439724	46439824	JUNC00001824	1	-	27	49	104.0	104.0	104.0
chrX	46440624	46440672	46440602	46440723	JUNC00001825	1	?	22	51	-304.0	-304.0	-304.0
chrX	46447346	46448199	46447288	46448268	JUNC00001826	30	+	58	69	-304.0	-304.0	-304.0
chrX	46447363	46448199	46447312	46448269	JUNC00001827	3	+	51	70	-304.0	-304.0	-304.0
chrX	46448310	46450430	46448237	46450475	JUNC00001828	48	+	73	45	-304.0	-304.0	-304.0
chrX	46450475	46462747	46450428	46462819	JUNC00001829	46	+	47	72	-304.0	-304.0	-304.0
chrX	46462829	46463193	46462804	46463244	JUNC00001831	1	?	25	51	-304.0	-304.0	-304.0
chrX	46462874	46463197	46462799	46463271	JUNC00001830	46	+	75	74	-304.0	-304.0	-304.0
chrX	46463293	46471141	46463237	46471160	JUNC00001833	1	+	56	19	-304.0	-304.0	-304.0
chrX	46463293	46472749	46463220	46472821	JUNC00001832	8	+	73	72	-304.0	-304.0	-304.0
chrX	46463308	46471141	46463252	46471185	JUNC00001834	11	+	56	44	-304.0	-304.0	-304.0
chrX	46463308	46472749	46463276	46472787	JUNC00001835	1	+	32	38	-304.0	-304.0	-304.0
chrX	46471185	46472024	46471138	46472080	JUNC00001837	2	+	47	56	-304.0	-304.0	-304.0
chrX	46471185	46472749	46471138	46472818	JUNC00001836	12	+	47	69	-304.0	-304.0	-304.0
chrX	46471185	46472752	46471152	46472794	JUNC00001838	1	+	33	42	-304.0	-304.0	-304.0
chrX	46472239	46472749	46472180	46472766	JUNC00001839	1	+	59	17	-304.0	-304.0	-304.0
chrX	46501332	46528349	46501287	46528380	JUNC00001841	1	-	45	31	-304.0	-304.0	-304.0
chrX	46501335	46528349	46501263	46528408	JUNC00001840	7	-	72	59	-304.0	-304.0	-304.0
chrX	46505032	46523473	46505017	46523517	JUNC00001821	3	+	15	44	-304.0	-304.0	-304.0
chrX	46516783	46519394	46516750	46519437	JUNC00001842	1	+	33	43	124.0	132.0	132.0
chrX	46523088	46528334	46523015	46528354	JUNC00001843	2	-	73	20	-304.0	-304.0	-304.0
chrX	46523125	46528349	46523050	46528407	JUNC00001844	2	-	75	58	-304.0	-304.0	-304.0
chrX	46523125	46528365	46523082	46528398	JUNC00001845	1	-	43	33	-304.0	-304.0	-304.0
chrX	46528445	46528782	46528371	46528852	JUNC00001846	5	-	74	70	-304.0	-304.0	-304.0
chrX	46528909	46542072	46528852	46542118	JUNC00001847	2	-	57	46	-304.0	-304.0	-304.0
chrX	46540571	46542072	46540554	46542116	JUNC00001848	1	-	17	44	-304.0	-304.0	-304.0
chrX	46542116	46544500	46542072	46544561	JUNC00001849	4	-	44	61	-304.0	-304.0	-304.0
chrX	46544611	46545358	46544557	46545380	JUNC00001851	1	-	54	22	-304.0	-304.0	-304.0
chrX	46544611	46545370	46544557	46545408	JUNC00001850	3	-	54	38	-304.0	-304.0	-304.0
chrX	46545627	46546465	46545585	46546533	JUNC00001852	5	+	42	68	-304.0	-304.0	-304.0
chrX	46545627	46563258	46545593	46563317	JUNC00001853	3	+	34	59	-304.0	-304.0	-304.0
chrX	46563351	46597759	46563283	46597788	JUNC00001854	2	+	68	29	-304.0	-304.0	-304.0
chrX	46575423	46597759	46575352	46597834	JUNC00001855	33	+	71	75	-304.0	-304.0	-304.0
chrX	46600562	46602186	46600525	46602261	JUNC00001856	5	-	37	75	-304.0	-304.0	-304.0
chrX	46601711	46602186	46601654	46602261	JUNC00001857	3	-	57	75	-304.0	-304.0	-304.0
chrX	46602270	46606907	46602235	46606953	JUNC00001859	2	-	35	46	-304.0	-304.0	-304.0
chrX	46602270	46606923	46602241	46606970	JUNC00001860	1	-	29	47	-304.0	-304.0	-304.0
chrX	46602270	46648685	46602197	46648757	JUNC00001858	5	-	73	72	-304.0	-304.0	-304.0
chrX	46603144	46603186	46603124	46603242	JUNC00001861	1	?	20	56	-304.0	-304.0	-304.0
chrX	46603172	46603305	46603125	46603334	JUNC00001862	1	?	47	29	-304.0	-304.0	-304.0
chrX	46603941	46606111	46603880	46606126	JUNC00001863	2	-	61	15	-304.0	-304.0	-304.0
chrX	46606370	46606907	46606301	46606981	JUNC00001864	25	-	69	74	-304.0	-304.0	-304.0
chrX	46606370	46606923	46606309	46606983	JUNC00001865	9	-	61	60	-304.0	-304.0	-304.0
chrX	46607002	46607053	46606966	46607093	JUNC00001866	1	?	36	40	-304.0	-304.0	-304.0
chrX	46607203	46613288	46607128	46613363	JUNC00001867	196	-	75	75	-304.0	-304.0	-304.0
chrX	46613394	46620976	46613320	46621048	JUNC00001868	135	-	74	72	-304.0	-304.0	-304.0
chrX	46621059	46631381	46620985	46631447	JUNC00001870	4	-	74	66	-304.0	-304.0	-304.0
chrX	46621059	46631585	46620985	46631654	JUNC00001869	163	-	74	69	-304.0	-304.0	-304.0
chrX	46625382	46625832	46625354	46625880	JUNC00001873	1	+	28	48	-304.0	-304.0	-304.0
chrX	46631649	46634582	46631615	46634624	JUNC00001874	1	-	34	42	-304.0	-304.0	-304.0
chrX	46631649	46635588	46631585	46635651	JUNC00001871	98	-	64	63	-304.0	-304.0	-304.0
chrX	46631649	46643235	46631585	46643310	JUNC00001872	46	-	64	75	-304.0	-304.0	-304.0
chrX	46635648	46643235	46635588	46643310	JUNC00001875	95	-	60	75	-304.0	-304.0	-304.0
chrX	46643389	46646597	46643315	46646666	JUNC00001877	16	-	74	69	-304.0	-304.0	-304.0
chrX	46643389	46648685	46643315	46648760	JUNC00001876	73	-	74	75	-304.0	-304.0	-304.0
chrX	46648393	46648685	46648357	46648758	JUNC00001878	3	-	36	73	-304.0	-304.0	-304.0
chrX	46648797	46651109	46648725	46651182	JUNC00001879	104	-	72	73	-304.0	-304.0	-304.0
chrX	46651223	46651315	46651149	46651390	JUNC00001880	122	-	74	75	-304.0	-304.0	-304.0
chrX	46651223	46653608	46651186	46653647	JUNC00001881	1	-	37	39	-304.0	-304.0	-304.0
chrX	46651404	46653608	46651329	46653681	JUNC00001882	108	-	75	73	-304.0	-304.0	-304.0
chrX	46653709	46662010	46653634	46662081	JUNC00001883	22	+	75	71	-304.0	-304.0	-304.0
chrX	46662157	46662537	46662084	46662611	JUNC00001884	95	-	73	74	-304.0	-304.0	-304.0
chrX	46662643	46669606	46662568	46669680	JUNC00001885	90	-	75	74	-304.0	-304.0	-304.0
chrX	46669719	46672550	46669644	46672624	JUNC00001886	133	-	75	74	-304.0	-304.0	-304.0
chrX	46672627	46679677	46672552	46679752	JUNC00001887	120	-	75	75	-304.0	-304.0	-304.0
chrX	46679755	46682335	46679680	46682409	JUNC00001888	82	-	75	74	-304.0	-304.0	-304.0
chrX	46682535	46758704	46682460	46758774	JUNC00001889	70	-	75	70	-304.0	-304.0	-304.0
chrX	46757310	46758704	46757279	46758768	JUNC00001890	2	-	31	64	-304.0	-304.0	-304.0
chrX	46831258	46868868	46831222	46868905	JUNC00001891	1	+	36	37	-304.0	-304.0	-304.0
chrX	46837202	46853475	46837129	46853548	JUNC00001892	29	+	73	73	-304.0	-304.0	-304.0
chrX	46854141	46859987	46854068	46860060	JUNC00001893	33	+	73	73	-304.0	-304.0	-304.0
chrX	46860102	46877504	46860028	46877575	JUNC00001894	56	+	74	71	-304.0	-304.0	-304.0
chrX	46877590	46879685	46877516	46879760	JUNC00001895	48	+	74	75	-304.0	-304.0	-304.0
chrX	46879793	46888647	46879737	46888667	JUNC00001896	1	+	56	20	-304.0	-304.0	-304.0
chrX	46903147	46925590	46903123	46925642	JUNC00001897	1	+	24	52	-304.0	-304.0	-304.0
chrX	46912340	46984883	46912323	46984942	JUNC00001898	2	+	17	59	-304.0	-304.0	-304.0
chrX	46912719	46984883	46912692	46984940	JUNC00001900	4	+	27	57	-304.0	-304.0	-304.0
chrX	46984940	46985712	46984883	46985783	JUNC00001899	14	+	57	71	-304.0	-304.0	-304.0
chrX	46985792	46998119	46985721	46998187	JUNC00001901	25	+	71	68	-304.0	-304.0	-304.0
chrX	46996829	46998119	46996778	46998167	JUNC00001902	2	+	51	48	-304.0	-304.0	-304.0
chrX	46998277	47024723	46998211	47024798	JUNC00001903	30	+	66	75	-304.0	-304.0	-304.0
chrX	47024914	47027891	47024841	47027957	JUNC00001904	22	+	73	66	-304.0	-304.0	-304.0
chrX	47028103	47033620	47028029	47033694	JUNC00001905	36	+	74	74	-304.0	-304.0	-304.0
chrX	47033788	47038948	47033723	47039019	JUNC00001906	32	+	65	71	-304.0	-304.0	-304.0
chrX	47039065	47054157	47039006	47054231	JUNC00001907	17	+	59	74	-304.0	-304.0	-304.0
chrX	47049275	47053346	47049228	47053375	JUNC00001908	1	-	47	29	-304.0	-304.0	-304.0
chrX	47054628	47056081	47054563	47056150	JUNC00001909	18	+	65	69	-304.0	-304.0	-304.0
chrX	47056199	47058166	47056124	47058236	JUNC00001910	22	+	75	70	-304.0	-304.0	-304.0
chrX	47075465	47079041	47075424	47079076	JUNC00001911	1	-	41	35	-304.0	-304.0	-304.0
chrX	47091809	47092060	47091760	47092094	JUNC00001912	2	+	49	34	-304.0	-304.0	-304.0
chrX	47107226	47185119	47107203	47185168	JUNC00001913	1	+	23	49	-304.0	-304.0	-304.0
chrX	47125850	47126245	47125834	47126305	JUNC00001914	1	-	16	60	-304.0	-304.0	-304.0
chrX	47126375	47129364	47126318	47129423	JUNC00001915	3	-	57	59	-304.0	-304.0	-304.0
chrX	47142440	47142583	47142365	47142658	JUNC00001916	236	-	75	75	-304.0	-304.0	-304.0
chrX	47142440	47142613	47142365	47142688	JUNC00001917	529	-	75	75	-304.0	-304.0	-304.0
chrX	47142744	47144296	47142712	47144338	JUNC00001920	1	-	32	42	-304.0	-304.0	-304.0
chrX	47142744	47144472	47142669	47144547	JUNC00001918	779	-	75	75	-304.0	-304.0	-304.0
chrX	47142744	47144482	47142705	47144519	JUNC00001919	1	-	39	37	-304.0	-304.0	-304.0
chrX	47145485	47147356	47145411	47147431	JUNC00001921	74	+	74	75	-304.0	-304.0	-304.0
chrX	47145516	47147356	47145448	47147430	JUNC00001922	14	+	68	74	-304.0	-304.0	-304.0
chrX	47147498	47151082	47147477	47151137	JUNC00001924	1	+	21	55	-304.0	-304.0	-304.0
chrX	47147498	47169314	47147424	47169389	JUNC00001923	83	+	74	75	-304.0	-304.0	-304.0
chrX	47151381	47169314	47151351	47169360	JUNC00001925	1	+	30	46	-304.0	-304.0	-304.0
chrX	47169498	47171027	47169428	47171097	JUNC00001926	50	+	70	70	-304.0	-304.0	-304.0
chrX	47169498	47173127	47169429	47173197	JUNC00001927	22	+	69	70	-304.0	-304.0	-304.0
chrX	47171258	47173127	47171191	47173197	JUNC00001928	71	+	67	70	-304.0	-304.0	-304.0
chrX	47173197	47175018	47173127	47175091	JUNC00001929	108	+	70	73	-304.0	-304.0	-304.0
chrX	47173197	47176499	47173155	47176572	JUNC00001930	8	+	42	73	-304.0	-304.0	-304.0
chrX	47175092	47176499	47175018	47176574	JUNC00001931	211	+	74	75	-304.0	-304.0	-304.0
chrX	47176586	47179102	47176511	47179163	JUNC00001932	154	+	75	61	-304.0	-304.0	-304.0
chrX	47179163	47179318	47179100	47179391	JUNC00001933	73	+	63	73	-304.0	-304.0	-304.0
chrX	47179495	47179879	47179421	47179953	JUNC00001934	100	+	74	74	-304.0	-304.0	-304.0
chrX	47180037	47180211	47179964	47180284	JUNC00001935	67	+	73	73	-304.0	-304.0	-304.0
chrX	47180040	47180211	47179967	47180283	JUNC00001936	66	+	73	72	-304.0	-304.0	-304.0
chrX	47180309	47180418	47180235	47180493	JUNC00001937	88	+	74	75	-304.0	-304.0	-304.0
chrX	47180506	47181214	47180434	47181287	JUNC00001938	79	+	72	73	-304.0	-304.0	-304.0
chrX	47181401	47181506	47181327	47181578	JUNC00001939	80	+	74	72	-304.0	-304.0	-304.0
chrX	47181646	47181748	47181571	47181822	JUNC00001940	154	+	75	74	-304.0	-304.0	-304.0
chrX	47181866	47181950	47181792	47182025	JUNC00001941	164	+	74	75	-304.0	-304.0	-304.0
chrX	47182042	47182161	47181968	47182236	JUNC00001942	190	+	74	75	-304.0	-304.0	-304.0
chrX	47182326	47185054	47182251	47185127	JUNC00001943	156	+	75	73	-304.0	-304.0	-304.0
chrX	47185204	47185301	47185129	47185372	JUNC00001944	192	+	75	71	-304.0	-304.0	-304.0
chrX	47185367	47185441	47185300	47185514	JUNC00001945	178	+	67	73	-304.0	-304.0	-304.0
chrX	47185630	47185715	47185556	47185790	JUNC00001946	237	+	74	75	-304.0	-304.0	-304.0
chrX	47185790	47186064	47185715	47186138	JUNC00001947	246	+	75	74	-304.0	-304.0	-304.0
chrX	47186171	47186257	47186098	47186332	JUNC00001948	236	+	73	75	-304.0	-304.0	-304.0
chrX	47186387	47186473	47186312	47186542	JUNC00001949	99	+	75	69	-304.0	-304.0	-304.0
chrX	47190950	47198802	47190877	47198877	JUNC00001950	124	+	73	75	-304.0	-304.0	-304.0
chrX	47192374	47198802	47192315	47198877	JUNC00001951	14	+	59	75	-304.0	-304.0	-304.0
chrX	47194024	47196355	47194008	47196415	JUNC00001956	1	+	16	60	-304.0	-304.0	-304.0
chrX	47194024	47196946	47193963	47197014	JUNC00001954	3	+	61	68	-304.0	-304.0	-304.0
chrX	47194024	47198166	47193996	47198214	JUNC00001955	1	+	28	48	-304.0	-304.0	-304.0
chrX	47194024	47198526	47193963	47198601	JUNC00001953	10	+	61	75	-304.0	-304.0	-304.0
chrX	47194024	47198802	47193957	47198877	JUNC00001952	246	+	67	75	-304.0	-304.0	-304.0
chrX	47198628	47198802	47198562	47198877	JUNC00001957	14	+	66	75	-304.0	-304.0	-304.0
chrX	47198651	47198802	47198590	47198876	JUNC00001958	7	+	61	74	-304.0	-304.0	-304.0
chrX	47198919	47199047	47198844	47199109	JUNC00001959	773	+	75	62	-304.0	-304.0	-304.0
chrX	47199106	47199208	47199047	47199283	JUNC00001960	589	+	59	75	-304.0	-304.0	-304.0
chrX	47199106	47199479	47199066	47199521	JUNC00001961	2	+	40	42	-304.0	-304.0	-304.0
chrX	47199377	47199479	47199302	47199554	JUNC00001962	447	+	75	75	-304.0	-304.0	-304.0
chrX	47199614	47200893	47199539	47200968	JUNC00001963	300	+	75	75	-304.0	-304.0	-304.0
chrX	47201000	47201275	47200925	47201350	JUNC00001964	405	+	75	75	-304.0	-304.0	-304.0
chrX	47201366	47201477	47201291	47201552	JUNC00001965	514	+	75	75	-304.0	-304.0	-304.0
chrX	47201610	47202155	47201535	47202227	JUNC00001966	503	+	75	72	-304.0	-304.0	-304.0
chrX	47202253	47202357	47202178	47202432	JUNC00001967	450	+	75	75	-304.0	-304.0	-304.0
chrX	47202504	47202637	47202429	47202712	JUNC00001968	582	+	75	75	-304.0	-304.0	-304.0
chrX	47202814	47202942	47202739	47203017	JUNC00001969	473	+	75	75	-304.0	-304.0	-304.0
chrX	47203047	47203133	47202972	47203208	JUNC00001970	569	+	75	75	-304.0	-304.0	-304.0
chrX	47203214	47203540	47203139	47203615	JUNC00001971	589	+	75	75	-304.0	-304.0	-304.0
chrX	47203696	47205947	47203621	47206022	JUNC00001972	666	+	75	75	-304.0	-304.0	-304.0
chrX	47203696	47206077	47203622	47206113	JUNC00001973	5	+	74	36	-304.0	-304.0	-304.0
chrX	47206113	47206247	47206038	47206322	JUNC00001974	728	+	75	75	-304.0	-304.0	-304.0
chrX	47206330	47209622	47206294	47209687	JUNC00001975	3	+	36	65	-304.0	-304.0	-304.0
chrX	47206444	47209622	47206369	47209687	JUNC00001977	588	+	75	65	-304.0	-304.0	-304.0
chrX	47209687	47209927	47209613	47210002	JUNC00001976	438	+	74	75	-304.0	-304.0	-304.0
chrX	47210123	47210655	47210048	47210674	JUNC00001979	2	+	75	19	-304.0	-304.0	-304.0
chrX	47210123	47210841	47210048	47210916	JUNC00001978	449	+	75	75	-304.0	-304.0	-304.0
chrX	47210916	47211035	47210841	47211110	JUNC00001980	654	+	75	75	-304.0	-304.0	-304.0
chrX	47211225	47212423	47211150	47212498	JUNC00001981	629	+	75	75	-304.0	-304.0	-304.0
chrX	47211384	47212423	47211348	47212460	JUNC00001982	1	+	36	37	-304.0	-304.0	-304.0
chrX	47212512	47212770	47212437	47212845	JUNC00001983	665	+	75	75	-304.0	-304.0	-304.0
chrX	47212863	47212989	47212788	47213064	JUNC00001984	674	+	75	75	-304.0	-304.0	-304.0
chrX	47213181	47214326	47213106	47214401	JUNC00001985	787	+	75	75	-304.0	-304.0	-304.0
chrX	47214428	47214536	47214353	47214611	JUNC00001986	563	+	75	75	-304.0	-304.0	-304.0
chrX	47214637	47214793	47214562	47214868	JUNC00001987	333	+	75	75	-304.0	-304.0	-304.0
chrX	47214994	47215016	47214920	47215051	JUNC00001988	4	?	74	35	108.0	108.0	108.0
chrX	47218664	47223551	47218600	47223606	JUNC00001989	3	+	64	55	-304.0	-304.0	-304.0
chrX	47219105	47223551	47219074	47223623	JUNC00001990	10	+	31	72	-304.0	-304.0	-304.0
chrX	47222342	47223551	47222283	47223573	JUNC00001991	2	+	59	22	-304.0	-304.0	-304.0
chrX	47222380	47223551	47222317	47223612	JUNC00001992	6	+	63	61	-304.0	-304.0	-304.0
chrX	47223759	47224384	47223685	47224459	JUNC00001993	138	+	74	75	-304.0	-304.0	-304.0
chrX	47224476	47224617	47224401	47224636	JUNC00001994	2	+	75	19	-304.0	-304.0	-304.0
chrX	47224518	47224617	47224443	47224692	JUNC00001995	144	+	75	75	-304.0	-304.0	-304.0
chrX	47224743	47224833	47224670	47224891	JUNC00001996	181	+	73	58	-304.0	-304.0	-304.0
chrX	47224890	47224987	47224833	47225062	JUNC00001997	171	+	57	75	-304.0	-304.0	-304.0
chrX	47225102	47225771	47225027	47225844	JUNC00001998	200	+	75	73	-304.0	-304.0	-304.0
chrX	47225102	47225964	47225046	47226027	JUNC00001999	4	+	56	63	-304.0	-304.0	-304.0
chrX	47225866	47225964	47225791	47226039	JUNC00002001	203	+	75	75	-304.0	-304.0	-304.0
chrX	47226027	47226278	47225963	47226352	JUNC00002000	180	+	64	74	-304.0	-304.0	-304.0
chrX	47226027	47226293	47225964	47226342	JUNC00002002	3	+	63	49	-304.0	-304.0	-304.0
chrX	47226027	47226582	47226005	47226636	JUNC00002003	1	+	22	54	-304.0	-304.0	-304.0
chrX	47226402	47226582	47226327	47226657	JUNC00002004	189	+	75	75	-304.0	-304.0	-304.0
chrX	47226703	47226811	47226628	47226886	JUNC00002005	181	+	75	75	-304.0	-304.0	-304.0
chrX	47226703	47226909	47226668	47226947	JUNC00002006	1	+	35	38	-304.0	-304.0	-304.0
chrX	47226909	47226993	47226834	47227068	JUNC00002007	149	+	75	75	-304.0	-304.0	-304.0
chrX	47227099	47227159	47227084	47227214	JUNC00002010	1	+	15	55	-304.0	-304.0	-304.0
chrX	47227099	47227180	47227024	47227223	JUNC00002008	137	+	75	43	-304.0	-304.0	-304.0
chrX	47227223	47227378	47227179	47227453	JUNC00002009	145	+	44	75	-304.0	-304.0	-304.0
chrX	47227469	47228566	47227398	47228641	JUNC00002011	149	+	71	75	-304.0	-304.0	-304.0
chrX	47227469	47228589	47227453	47228644	JUNC00002012	1	+	16	55	-304.0	-304.0	-304.0
chrX	47228644	47228730	47228569	47228805	JUNC00002013	126	+	75	75	-304.0	-304.0	-304.0
chrX	47233219	47239069	47233144	47239142	JUNC00002014	69	+	75	73	-304.0	-304.0	-304.0
chrX	47233533	47239069	47233494	47239106	JUNC00002015	2	+	39	37	-304.0	-304.0	-304.0
chrX	47233912	47239069	47233892	47239125	JUNC00002016	1	+	20	56	-304.0	-304.0	-304.0
chrX	47239179	47239350	47239105	47239425	JUNC00002017	111	+	74	75	-304.0	-304.0	-304.0
chrX	47239481	47239789	47239406	47239864	JUNC00002018	110	+	75	75	-304.0	-304.0	-304.0
chrX	47239907	47240304	47239833	47240379	JUNC00002019	116	+	74	75	-304.0	-304.0	-304.0
chrX	47240450	47240586	47240377	47240649	JUNC00002020	94	+	73	63	-304.0	-304.0	-304.0
chrX	47240648	47240773	47240585	47240848	JUNC00002021	115	+	63	75	-304.0	-304.0	-304.0
chrX	47240649	47240777	47240586	47240784	JUNC00002022	7	+	63	7	-304.0	-304.0	-304.0
chrX	47240649	47240777	47240615	47240819	JUNC00002023	1	?	34	42	-304.0	-304.0	-304.0
chrX	47240876	47241276	47240803	47241349	JUNC00002024	136	+	73	73	-304.0	-304.0	-304.0
chrX	47241450	47241540	47241375	47241615	JUNC00002025	105	+	75	75	-304.0	-304.0	-304.0
chrX	47241699	47242081	47241626	47242156	JUNC00002026	132	+	73	75	-304.0	-304.0	-304.0
chrX	47242306	47242438	47242231	47242512	JUNC00002027	131	+	75	74	-304.0	-304.0	-304.0
chrX	47242522	47242625	47242447	47242699	JUNC00002028	88	+	75	74	-304.0	-304.0	-304.0
chrX	47242720	47243395	47242646	47243468	JUNC00002029	63	+	74	73	-304.0	-304.0	-304.0
chrX	47243602	47244497	47243527	47244550	JUNC00002030	139	+	75	53	-304.0	-304.0	-304.0
chrX	47244550	47244681	47244497	47244755	JUNC00002031	130	+	53	74	-304.0	-304.0	-304.0
chrX	47244550	47244684	47244497	47244758	JUNC00002032	12	+	53	74	-304.0	-304.0	-304.0
chrX	47244924	47245015	47244849	47245087	JUNC00002033	136	+	75	72	-304.0	-304.0	-304.0
chrX	47245086	47245369	47245014	47245442	JUNC00002034	144	+	72	73	-304.0	-304.0	-304.0
chrX	47245482	47247071	47245407	47247146	JUNC00002035	160	+	75	75	-304.0	-304.0	-304.0
chrX	47247221	47247303	47247146	47247377	JUNC00002036	126	+	75	74	-304.0	-304.0	-304.0
chrX	47247419	47247610	47247345	47247679	JUNC00002037	128	+	74	69	-304.0	-304.0	-304.0
chrX	47247699	47247792	47247626	47247867	JUNC00002038	69	+	73	75	-304.0	-304.0	-304.0
chrX	47342746	47357360	47342722	47357412	JUNC00002039	1	+	24	52	-304.0	-304.0	-304.0
chrX	47385798	47397645	47385765	47397687	JUNC00002040	1	-	33	42	-304.0	-304.0	-304.0
chrX	47409725	47428571	47409689	47428611	JUNC00002041	1	-	36	40	-304.0	-304.0	-304.0
chrX	47449474	47455920	47449403	47455991	JUNC00002042	21	-	71	71	-304.0	-304.0	-304.0
chrX	47456016	47456271	47455942	47456340	JUNC00002043	20	-	74	69	-304.0	-304.0	-304.0
chrX	47456398	47467409	47456324	47467478	JUNC00002044	16	-	74	69	-304.0	-304.0	-304.0
chrX	47456414	47467409	47456353	47467442	JUNC00002045	5	-	61	33	-304.0	-304.0	-304.0
chrX	47456414	47483094	47456371	47483127	JUNC00002046	1	-	43	33	-304.0	-304.0	-304.0
chrX	47467760	47483094	47467688	47483163	JUNC00002047	8	-	72	69	-304.0	-304.0	-304.0
chrX	47469842	47483094	47469816	47483163	JUNC00002048	2	-	26	69	-304.0	-304.0	-304.0
chrX	47470699	47483094	47470673	47483163	JUNC00002049	2	-	26	69	-304.0	-304.0	-304.0
chrX	47475077	47478404	47475056	47478442	JUNC00002050	1	+	21	38	-304.0	-304.0	-304.0
chrX	47478442	47484909	47478404	47484926	JUNC00002051	1	+	38	17	-304.0	-304.0	-304.0
chrX	47505166	47529859	47505151	47529920	JUNC00002052	1	+	15	61	-304.0	-304.0	-304.0
chrX	47548454	47580412	47548426	47580460	JUNC00002053	1	-	28	48	-304.0	-304.0	-304.0
chrX	47561251	47562908	47561206	47562983	JUNC00002054	23	+	45	75	-304.0	-304.0	-304.0
chrX	47563063	47563225	47562988	47563298	JUNC00002055	111	+	75	73	-304.0	-304.0	-304.0
chrX	47563329	47564796	47563254	47564871	JUNC00002056	155	+	75	75	-304.0	-304.0	-304.0
chrX	47564899	47564984	47564824	47565059	JUNC00002057	203	+	75	75	-304.0	-304.0	-304.0
chrX	47565098	47565251	47565073	47565302	JUNC00002059	1	+	25	51	-304.0	-304.0	-304.0
chrX	47565139	47565233	47565086	47565270	JUNC00002060	2	?	53	37	-304.0	-304.0	-304.0
chrX	47565139	47565242	47565109	47565305	JUNC00002061	2	?	30	63	-304.0	-304.0	-304.0
chrX	47565139	47565251	47565064	47565321	JUNC00002058	177	+	75	70	-304.0	-304.0	-304.0
chrX	47565350	47566623	47565275	47566690	JUNC00002063	7	+	75	67	-304.0	-304.0	-304.0
chrX	47565350	47566638	47565275	47566713	JUNC00002062	144	+	75	75	-304.0	-304.0	-304.0
chrX	47566543	47566638	47566509	47566680	JUNC00002064	1	+	34	42	-304.0	-304.0	-304.0
chrX	47566780	47566883	47566705	47566940	JUNC00002065	185	+	75	57	-304.0	-304.0	-304.0
chrX	47566911	47566985	47566881	47567055	JUNC00002066	187	+	30	70	-304.0	-304.0	-304.0
chrX	47567131	47567229	47567056	47567304	JUNC00002067	156	+	75	75	-304.0	-304.0	-304.0
chrX	47567432	47568717	47567357	47568792	JUNC00002068	193	+	75	75	-304.0	-304.0	-304.0
chrX	47568894	47568986	47568819	47569039	JUNC00002069	150	+	75	53	-304.0	-304.0	-304.0
chrX	47569657	47569892	47569583	47569965	JUNC00002070	181	+	74	73	-304.0	-304.0	-304.0
chrX	47570024	47570877	47569950	47570952	JUNC00002071	108	+	74	75	-304.0	-304.0	-304.0
chrX	47571012	47571322	47570940	47571397	JUNC00002072	124	+	72	75	-304.0	-304.0	-304.0
chrX	47572961	47574001	47572921	47574037	JUNC00002073	1	-	40	36	-304.0	-304.0	-304.0
chrX	47576233	47576331	47576209	47576383	JUNC00002074	1	-	24	52	-304.0	-304.0	-304.0
chrX	47582474	47583407	47582400	47583482	JUNC00002075	684	+	74	75	-304.0	-304.0	-304.0
chrX	47582474	47584935	47582428	47585010	JUNC00002076	11	+	46	75	-304.0	-304.0	-304.0
chrX	47582590	47583407	47582573	47583482	JUNC00002077	6	+	17	75	-304.0	-304.0	-304.0
chrX	47583536	47584935	47583461	47585010	JUNC00002078	1019	+	75	75	-304.0	-304.0	-304.0
chrX	47585015	47585204	47584940	47585279	JUNC00002079	678	+	75	75	-304.0	-304.0	-304.0
chrX	47585331	47585542	47585256	47585617	JUNC00002080	618	+	75	75	-304.0	-304.0	-304.0
chrX	47585667	47586520	47585592	47586595	JUNC00002081	469	+	75	75	-304.0	-304.0	-304.0
chrX	47605067	47605222	47605039	47605270	JUNC00002082	1	-	28	48	-304.0	-304.0	-304.0
chrX	47607036	47607140	47606985	47607165	JUNC00002083	1	-	51	25	-304.0	-304.0	-304.0
chrX	47607198	47619351	47607143	47619408	JUNC00002084	2	-	55	57	-304.0	-304.0	-304.0
chrX	47614050	47614174	47614011	47614211	JUNC00002085	1	-	39	37	-304.0	-304.0	-304.0
chrX	47624440	47626057	47624375	47626132	JUNC00002086	21	-	65	75	-304.0	-304.0	-304.0
chrX	47626169	47626327	47626096	47626402	JUNC00002087	21	-	73	75	-304.0	-304.0	-304.0
chrX	47626519	47626772	47626451	47626846	JUNC00002088	17	-	68	74	-304.0	-304.0	-304.0
chrX	47627332	47627470	47627294	47627523	JUNC00002089	3	-	38	53	-304.0	-304.0	-304.0
chrX	47627641	47628101	47627623	47628159	JUNC00002090	1	-	18	58	-304.0	-304.0	-304.0
chrX	47628277	47629523	47628205	47629594	JUNC00002091	18	-	72	71	-304.0	-304.0	-304.0
chrX	47629645	47629768	47629607	47629806	JUNC00002094	1	-	38	38	-304.0	-304.0	-304.0
chrX	47629649	47630065	47629590	47630082	JUNC00002092	1	+	59	17	-304.0	-304.0	-304.0
chrX	47629674	47629768	47629604	47629819	JUNC00002093	6	-	70	51	-304.0	-304.0	-304.0
chrX	47636415	47636576	47636340	47636611	JUNC00002095	2	-	75	35	-304.0	-304.0	-304.0
chrX	47636927	47637012	47636852	47637087	JUNC00002096	229	-	75	75	-304.0	-304.0	-304.0
chrX	47637114	47637750	47637041	47637825	JUNC00002097	116	-	73	75	-304.0	-304.0	-304.0
chrX	47638182	47638894	47638111	47638969	JUNC00002098	111	-	71	75	-304.0	-304.0	-304.0
chrX	47639338	47641231	47639263	47641306	JUNC00002099	210	-	75	75	-304.0	-304.0	-304.0
chrX	47641475	47649920	47641400	47649994	JUNC00002100	74	-	75	74	-304.0	-304.0	-304.0
chrX	47641475	47650422	47641400	47650495	JUNC00002101	53	-	75	73	-304.0	-304.0	-304.0
chrX	47641503	47650422	47641473	47650468	JUNC00002102	1	-	30	46	-304.0	-304.0	-304.0
chrX	47650026	47650422	47649951	47650489	JUNC00002103	37	-	75	67	-304.0	-304.0	-304.0
chrX	47651895	47652080	47651820	47652144	JUNC00002104	536	-	75	64	-304.0	-304.0	-304.0
chrX	47652144	47654028	47652080	47654053	JUNC00002106	4	-	64	25	-304.0	-304.0	-304.0
chrX	47652144	47657182	47652075	47657257	JUNC00002105	757	-	69	75	-304.0	-304.0	-304.0
chrX	47652144	47657204	47652080	47657279	JUNC00002107	25	-	64	75	-304.0	-304.0	-304.0
chrX	47652144	47657571	47652093	47657596	JUNC00002108	1	-	51	25	-304.0	-304.0	-304.0
chrX	47654053	47657182	47654028	47657229	JUNC00002109	3	-	25	47	-304.0	-304.0	-304.0
chrX	47656338	47657182	47656307	47657234	JUNC00002110	3	-	31	52	-304.0	-304.0	-304.0
chrX	47656948	47657182	47656903	47657257	JUNC00002111	2	-	45	75	-304.0	-304.0	-304.0
chrX	47657266	47657612	47657213	47657635	JUNC00002112	1	?	53	23	-304.0	-304.0	-304.0
chrX	47657285	47657571	47657227	47657588	JUNC00002115	1	-	58	17	-304.0	-304.0	-304.0
chrX	47657290	47657571	47657215	47657642	JUNC00002113	778	-	75	71	-304.0	-304.0	-304.0
chrX	47657290	47657781	47657226	47657856	JUNC00002114	6	-	64	75	-304.0	-304.0	-304.0
chrX	47657639	47657781	47657571	47657856	JUNC00002116	861	-	68	75	-304.0	-304.0	-304.0
chrX	47657863	47658538	47657844	47658595	JUNC00002118	1	-	19	57	-304.0	-304.0	-304.0
chrX	47657863	47658829	47657788	47658904	JUNC00002117	759	-	75	75	-304.0	-304.0	-304.0
chrX	47658936	47659114	47658861	47659165	JUNC00002119	125	-	75	51	-304.0	-304.0	-304.0
chrX	47659180	47659894	47659156	47659958	JUNC00002120	2	+	24	64	-304.0	-304.0	-304.0
chrX	47760043	47849687	47760023	47849743	JUNC00002121	1	+	20	56	-304.0	-304.0	-304.0
chrX	47836987	47846104	47836917	47846177	JUNC00002122	6	+	70	73	-304.0	-304.0	-304.0
chrX	47837007	47846104	47836935	47846154	JUNC00002123	6	+	72	50	-304.0	-304.0	-304.0
chrX	47842768	47846104	47842696	47846174	JUNC00002124	6	+	72	70	-304.0	-304.0	-304.0
chrX	47846321	47860719	47846274	47860748	JUNC00002126	1	+	47	29	-304.0	-304.0	-304.0
chrX	47846321	47887998	47846248	47888061	JUNC00002125	18	+	73	63	-304.0	-304.0	-304.0
chrX	47888125	47895844	47888055	47895916	JUNC00002127	8	+	70	72	-304.0	-304.0	-304.0
chrX	47895940	47914923	47895871	47914994	JUNC00002128	7	+	69	71	-304.0	-304.0	-304.0
chrX	47977797	47982948	47977724	47983022	JUNC00002129	16	-	73	74	-304.0	-304.0	-304.0
chrX	47983038	47983284	47982975	47983355	JUNC00002130	14	-	63	71	-304.0	-304.0	-304.0
chrX	47983411	47988523	47983349	47988596	JUNC00002132	14	-	62	73	-304.0	-304.0	-304.0
chrX	47983411	48002594	47983348	48002653	JUNC00002131	3	-	63	59	-304.0	-304.0	-304.0
chrX	47988617	47997108	47988575	47997142	JUNC00002135	1	-	42	34	-304.0	-304.0	-304.0
chrX	47988617	48002594	47988561	48002653	JUNC00002134	5	-	56	59	-304.0	-304.0	-304.0
chrX	47988659	48002594	47988604	48002616	JUNC00002136	2	-	55	22	-304.0	-304.0	-304.0
chrX	48002653	48003507	48002594	48003566	JUNC00002133	7	-	59	59	-304.0	-304.0	-304.0
chrX	48003702	48003903	48003645	48003955	JUNC00002138	4	-	57	52	-304.0	-304.0	-304.0
chrX	48003702	48003908	48003639	48003974	JUNC00002137	10	-	63	66	-304.0	-304.0	-304.0
chrX	48007947	48008375	48007908	48008412	JUNC00002139	2	+	39	37	-304.0	-304.0	-304.0
chrX	48046310	48057270	48046250	48057286	JUNC00002140	1	-	60	16	-304.0	-304.0	-304.0
chrX	48060203	48060449	48060142	48060511	JUNC00002141	5	-	61	62	-304.0	-304.0	-304.0
chrX	48060545	48060818	48060506	48060885	JUNC00002143	5	-	39	67	-304.0	-304.0	-304.0
chrX	48060545	48066871	48060490	48066892	JUNC00002142	1	-	55	21	-304.0	-304.0	-304.0
chrX	48060945	48066871	48060893	48066921	JUNC00002144	3	-	52	50	-304.0	-304.0	-304.0
chrX	48115151	48115347	48115097	48115369	JUNC00002145	1	+	54	22	-304.0	-304.0	-304.0
chrX	48130832	48131260	48130793	48131297	JUNC00002146	1	+	39	37	-304.0	-304.0	-304.0
chrX	48236096	48252234	48236060	48252290	JUNC00002147	2	+	36	56	114.0	-304.0	114.0
chrX	48362029	48375719	48362005	48375770	JUNC00002148	1	+	24	51	-304.0	-304.0	-304.0
chrX	48375156	48418556	48375124	48418600	JUNC00002149	1	-	32	44	126.0	144.0	144.0
chrX	48458764	48458887	48458689	48458941	JUNC00002150	2	-	75	54	-304.0	-304.0	-304.0
chrX	48458764	48459535	48458689	48459610	JUNC00002151	18	-	75	75	-304.0	-304.0	-304.0
chrX	48459034	48459535	48458959	48459610	JUNC00002152	128	-	75	75	-304.0	-304.0	-304.0
chrX	48459639	48459731	48459564	48459806	JUNC00002153	170	-	75	75	-304.0	-304.0	-304.0
chrX	48459876	48460648	48459805	48460722	JUNC00002154	98	-	71	74	-304.0	-304.0	-304.0
chrX	48460760	48460843	48460715	48460874	JUNC00002156	1	-	45	31	-304.0	-304.0	-304.0
chrX	48460764	48460985	48460690	48461057	JUNC00002155	107	-	74	72	-304.0	-304.0	-304.0
chrX	48461086	48461717	48461012	48461792	JUNC00002157	141	-	74	75	-304.0	-304.0	-304.0
chrX	48461797	48462006	48461723	48462081	JUNC00002158	97	-	74	75	-304.0	-304.0	-304.0
chrX	48462144	48462232	48462069	48462291	JUNC00002159	148	-	75	59	-304.0	-304.0	-304.0
chrX	48462291	48462897	48462226	48462972	JUNC00002160	147	-	65	75	-304.0	-304.0	-304.0
chrX	48462980	48466014	48462905	48466089	JUNC00002161	167	-	75	75	-304.0	-304.0	-304.0
chrX	48463712	48543819	48463672	48543855	JUNC00002162	1	+	40	36	-304.0	-304.0	-304.0
chrX	48466093	48466229	48466018	48466304	JUNC00002164	173	-	75	75	-304.0	-304.0	-304.0
chrX	48466093	48466798	48466018	48466860	JUNC00002163	7	-	75	62	-304.0	-304.0	-304.0
chrX	48466322	48466798	48466247	48466870	JUNC00002165	124	-	75	72	-304.0	-304.0	-304.0
chrX	48466872	48466961	48466798	48467035	JUNC00002166	151	-	74	74	-304.0	-304.0	-304.0
chrX	48467077	48467709	48467003	48467782	JUNC00002167	90	-	74	73	-304.0	-304.0	-304.0
chrX	48467779	48467871	48467709	48467917	JUNC00002168	3	-	70	46	-304.0	-304.0	-304.0
chrX	48467785	48467871	48467712	48467928	JUNC00002169	101	-	73	57	-304.0	-304.0	-304.0
chrX	48467925	48468304	48467871	48468344	JUNC00002170	6	-	54	40	-304.0	-304.0	-304.0
chrX	48467925	48468504	48467883	48468537	JUNC00002174	1	-	42	33	-304.0	-304.0	-304.0
chrX	48467925	48468884	48467871	48468910	JUNC00002172	2	-	54	26	-304.0	-304.0	-304.0
chrX	48467925	48469330	48467871	48469381	JUNC00002173	4	-	54	51	-304.0	-304.0	-304.0
chrX	48467925	48469334	48467871	48469409	JUNC00002171	105	-	54	75	-304.0	-304.0	-304.0
chrX	48469436	48469529	48469385	48469553	JUNC00002175	1	-	51	24	-304.0	-304.0	-304.0
chrX	48475188	48475878	48475155	48475921	JUNC00002176	1	-	33	43	-304.0	-304.0	-304.0
chrX	48476396	48477934	48476370	48477984	JUNC00002179	1	+	26	50	-304.0	-304.0	-304.0
chrX	48476396	48477960	48476322	48478033	JUNC00002177	90	+	74	73	-304.0	-304.0	-304.0
chrX	48476396	48478023	48476346	48478098	JUNC00002178	2	+	50	75	-304.0	-304.0	-304.0
chrX	48476668	48477960	48476596	48478004	JUNC00002180	6	+	72	44	-304.0	-304.0	-304.0
chrX	48478168	48478448	48478093	48478519	JUNC00002181	114	+	75	71	-304.0	-304.0	-304.0
chrX	48478518	48478616	48478444	48478691	JUNC00002182	94	+	74	75	-304.0	-304.0	-304.0
chrX	48478707	48479037	48478632	48479112	JUNC00002183	100	+	75	75	-304.0	-304.0	-304.0
chrX	48479116	48481150	48479042	48481219	JUNC00002184	101	+	74	69	-304.0	-304.0	-304.0
chrX	48481203	48481288	48481149	48481342	JUNC00002185	93	+	54	54	-304.0	-304.0	-304.0
chrX	48481342	48481425	48481277	48481500	JUNC00002186	108	+	65	75	-304.0	-304.0	-304.0
chrX	48481528	48481631	48481453	48481705	JUNC00002187	155	+	75	74	-304.0	-304.0	-304.0
chrX	48481715	48482402	48481640	48482477	JUNC00002188	123	+	75	75	-304.0	-304.0	-304.0
chrX	48481715	48482408	48481640	48482481	JUNC00002189	43	+	75	73	-304.0	-304.0	-304.0
chrX	48482506	48482596	48482432	48482671	JUNC00002190	145	+	74	75	-304.0	-304.0	-304.0
chrX	48482506	48482662	48482460	48482710	JUNC00002191	2	+	46	48	-304.0	-304.0	-304.0
chrX	48482794	48482985	48482720	48483027	JUNC00002192	72	+	74	42	-304.0	-304.0	-304.0
chrX	48482794	48483252	48482760	48483293	JUNC00002193	1	+	34	41	-304.0	-304.0	-304.0
chrX	48483027	48485735	48482966	48485809	JUNC00002194	94	+	61	74	-304.0	-304.0	-304.0
chrX	48483027	48485774	48482985	48485849	JUNC00002195	4	+	42	75	-304.0	-304.0	-304.0
chrX	48483341	48485735	48483273	48485783	JUNC00002196	2	+	68	48	-304.0	-304.0	-304.0
chrX	48507055	48508718	48507005	48508744	JUNC00002197	1	-	50	26	-304.0	-304.0	-304.0
chrX	48508639	48508725	48508606	48508767	JUNC00002198	1	+	33	42	-304.0	-304.0	-304.0
chrX	48509103	48509423	48509038	48509463	JUNC00002199	3	+	65	40	-304.0	-304.0	-304.0
chrX	48509103	48509783	48509053	48509847	JUNC00002200	5	+	50	64	-304.0	-304.0	-304.0
chrX	48509549	48509783	48509528	48509838	JUNC00002201	1	+	21	55	-304.0	-304.0	-304.0
chrX	48509707	48509783	48509669	48509834	JUNC00002204	2	+	38	51	-304.0	-304.0	-304.0
chrX	48509707	48509892	48509640	48509949	JUNC00002202	2	+	67	57	-304.0	-304.0	-304.0
chrX	48509707	48511365	48509669	48511403	JUNC00002203	1	+	38	38	-304.0	-304.0	-304.0
chrX	48509956	48511294	48509885	48511368	JUNC00002205	18	+	71	74	-304.0	-304.0	-304.0
chrX	48509956	48511365	48509896	48511413	JUNC00002206	4	+	60	48	-304.0	-304.0	-304.0
chrX	48511487	48511891	48511421	48511936	JUNC00002207	26	+	66	45	-304.0	-304.0	-304.0
chrX	48511935	48512325	48511891	48512398	JUNC00002208	20	+	44	73	-304.0	-304.0	-304.0
chrX	48512507	48512588	48512443	48512661	JUNC00002209	11	+	64	73	-304.0	-304.0	-304.0
chrX	48512719	48512834	48512645	48512852	JUNC00002210	10	+	74	18	-304.0	-304.0	-304.0
chrX	48512719	48514239	48512651	48514307	JUNC00002211	11	+	68	68	-304.0	-304.0	-304.0
chrX	48512852	48514126	48512834	48514144	JUNC00002212	3	+	18	18	-304.0	-304.0	-304.0
chrX	48512852	48514239	48512834	48514304	JUNC00002213	4	+	18	65	-304.0	-304.0	-304.0
chrX	48514141	48514239	48514126	48514262	JUNC00002214	1	+	15	23	-304.0	-304.0	-304.0
chrX	48514365	48514524	48514293	48514592	JUNC00002215	25	+	72	68	-304.0	-304.0	-304.0
chrX	48514625	48515716	48514553	48515786	JUNC00002216	24	+	72	70	-304.0	-304.0	-304.0
chrX	48515793	48515889	48515718	48515953	JUNC00002217	35	+	75	64	-304.0	-304.0	-304.0
chrX	48515953	48516060	48515889	48516132	JUNC00002218	26	+	64	72	-304.0	-304.0	-304.0
chrX	48516146	48517182	48516071	48517249	JUNC00002219	35	+	75	67	-304.0	-304.0	-304.0
chrX	48517293	48520374	48517219	48520445	JUNC00002220	26	+	74	71	-304.0	-304.0	-304.0
chrX	48517633	48600909	48517611	48600963	JUNC00002221	1	-	22	54	-304.0	-304.0	-304.0
chrX	48521118	48521468	48521100	48521526	JUNC00002222	1	+	18	58	-304.0	-304.0	-304.0
chrX	48521907	48522144	48521886	48522199	JUNC00002229	1	+	21	55	-304.0	-304.0	-304.0
chrX	48521907	48523698	48521834	48523764	JUNC00002223	75	+	73	66	-304.0	-304.0	-304.0
chrX	48521907	48523753	48521843	48523828	JUNC00002224	22	+	64	75	-304.0	-304.0	-304.0
chrX	48521907	48523922	48521855	48523997	JUNC00002225	7	+	52	75	-304.0	-304.0	-304.0
chrX	48521907	48523982	48521862	48524038	JUNC00002226	2	+	45	56	-304.0	-304.0	-304.0
chrX	48521907	48526988	48521884	48527025	JUNC00002227	1	+	23	37	-304.0	-304.0	-304.0
chrX	48522192	48523698	48522152	48523734	JUNC00002230	2	+	40	36	-304.0	-304.0	-304.0
chrX	48522252	48523753	48522216	48523828	JUNC00002231	6	+	36	75	-304.0	-304.0	-304.0
chrX	48524072	48526988	48523997	48527026	JUNC00002232	392	+	75	38	-304.0	-304.0	-304.0
chrX	48527025	48527154	48526988	48527229	JUNC00002228	361	+	37	75	-304.0	-304.0	-304.0
chrX	48527285	48528097	48527251	48528139	JUNC00002235	1	+	34	42	-304.0	-304.0	-304.0
chrX	48527285	48528233	48527210	48528308	JUNC00002233	471	+	75	75	-304.0	-304.0	-304.0
chrX	48527285	48531715	48527255	48531761	JUNC00002236	1	+	30	46	-304.0	-304.0	-304.0
chrX	48527285	48535967	48527255	48536013	JUNC00002237	1	+	30	46	-304.0	-304.0	-304.0
chrX	48527285	48558896	48527229	48558916	JUNC00002234	1	+	56	20	-304.0	-304.0	-304.0
chrX	48536038	48541332	48535995	48541365	JUNC00002238	1	+	43	33	-304.0	-304.0	-304.0
chrX	48539920	48541332	48539849	48541406	JUNC00002239	37	+	71	74	-304.0	-304.0	-304.0
chrX	48541438	48558896	48541363	48558935	JUNC00002240	3	+	75	39	-304.0	-304.0	-304.0
chrX	48541442	48544826	48541397	48544857	JUNC00002243	1	+	45	31	-304.0	-304.0	-304.0
chrX	48541442	48544868	48541368	48544943	JUNC00002241	47	+	74	75	-304.0	-304.0	-304.0
chrX	48541442	48549513	48541414	48549561	JUNC00002244	1	+	28	48	-304.0	-304.0	-304.0
chrX	48541442	48558896	48541378	48558967	JUNC00002242	7	+	64	71	-304.0	-304.0	-304.0
chrX	48545023	48549513	48544948	48549585	JUNC00002245	5	+	75	72	-304.0	-304.0	-304.0
chrX	48545023	48558896	48544948	48558970	JUNC00002246	49	+	75	74	-304.0	-304.0	-304.0
chrX	48545023	48559157	48544975	48559185	JUNC00002247	1	+	48	28	-304.0	-304.0	-304.0
chrX	48549357	48558896	48549314	48558929	JUNC00002248	1	+	43	33	-304.0	-304.0	-304.0
chrX	48559024	48559157	48558949	48559231	JUNC00002249	61	+	75	74	-304.0	-304.0	-304.0
chrX	48559346	48559613	48559275	48559688	JUNC00002250	86	+	71	75	-304.0	-304.0	-304.0
chrX	48566024	48578549	48566007	48578570	JUNC00002251	2	+	17	21	92.0	98.0	98.0
chrX	48569273	48578549	48569249	48578570	JUNC00002252	3	+	24	21	-304.0	-304.0	-304.0
chrX	48570615	48578016	48570594	48578091	JUNC00002253	122	+	21	75	112.0	-304.0	112.0
chrX	48574573	48575167	48574499	48575242	JUNC00002254	1400	+	74	75	-304.0	-304.0	-304.0
chrX	48574676	48575167	48574652	48575219	JUNC00002255	1	+	24	52	-304.0	-304.0	-304.0
chrX	48575036	48575167	48574981	48575232	JUNC00002256	3	+	55	65	-304.0	-304.0	-304.0
chrX	48575283	48575560	48575208	48575635	JUNC00002257	1832	+	75	75	-304.0	-304.0	-304.0
chrX	48575283	48576313	48575213	48576388	JUNC00002258	32	+	70	75	-304.0	-304.0	-304.0
chrX	48575667	48575814	48575600	48575851	JUNC00002260	6	+	67	37	-304.0	-304.0	-304.0
chrX	48575667	48575921	48575622	48575964	JUNC00002261	3	+	45	43	-304.0	-304.0	-304.0
chrX	48575667	48576313	48575592	48576388	JUNC00002259	1664	+	75	75	-304.0	-304.0	-304.0
chrX	48576083	48576313	48576010	48576381	JUNC00002262	10	+	73	68	-304.0	-304.0	-304.0
chrX	48576419	48576507	48576344	48576582	JUNC00002263	1073	+	75	75	-304.0	-304.0	-304.0
chrX	48576604	48577025	48576529	48577100	JUNC00002264	1343	+	75	75	-304.0	-304.0	-304.0
chrX	48577109	48577464	48577034	48577539	JUNC00002265	913	+	75	75	-304.0	-304.0	-304.0
chrX	48578016	48596619	48577971	48596650	JUNC00002266	1	+	45	31	-304.0	-304.0	-304.0
chrX	48597614	48597957	48597545	48598018	JUNC00002267	4	+	69	61	-304.0	-304.0	-304.0
chrX	48597652	48597955	48597603	48598006	JUNC00002268	2	?	49	51	-304.0	-304.0	-304.0
chrX	48598037	48598716	48597968	48598790	JUNC00002269	25	+	69	74	-304.0	-304.0	-304.0
chrX	48598957	48599352	48598883	48599427	JUNC00002270	52	+	74	75	-304.0	-304.0	-304.0
chrX	48599462	48599586	48599387	48599659	JUNC00002271	51	+	75	73	-304.0	-304.0	-304.0
chrX	48599717	48600318	48599642	48600390	JUNC00002272	59	+	75	72	-304.0	-304.0	-304.0
chrX	48600626	48601783	48600551	48601858	JUNC00002273	149	+	75	75	-304.0	-304.0	-304.0
chrX	48601964	48602064	48601889	48602139	JUNC00002274	121	+	75	75	-304.0	-304.0	-304.0
chrX	48602206	48604271	48602133	48604346	JUNC00002275	134	+	73	75	-304.0	-304.0	-304.0
chrX	48604390	48604847	48604317	48604922	JUNC00002276	148	+	73	75	-304.0	-304.0	-304.0
chrX	48604390	48604857	48604364	48604907	JUNC00002277	1	+	26	50	-304.0	-304.0	-304.0
chrX	48605706	48691106	48605688	48691163	JUNC00002278	1	+	18	57	-304.0	-304.0	-304.0
chrX	48613211	48691106	48613193	48691163	JUNC00002279	1	+	18	57	-304.0	-304.0	-304.0
chrX	48616350	48691106	48616332	48691163	JUNC00002280	1	+	18	57	-304.0	-304.0	-304.0
chrX	48630523	48671886	48630505	48671939	JUNC00002281	1	-	18	53	-304.0	-304.0	-304.0
chrX	48655512	48667317	48655485	48667362	JUNC00002282	1	-	27	45	-304.0	-304.0	-304.0
chrX	48683985	48684282	48683910	48684357	JUNC00002283	458	+	75	75	-304.0	-304.0	-304.0
chrX	48684423	48685546	48684348	48685621	JUNC00002284	292	+	75	75	-304.0	-304.0	-304.0
chrX	48684423	48685733	48684348	48685800	JUNC00002285	6	+	75	67	-304.0	-304.0	-304.0
chrX	48685633	48685733	48685558	48685807	JUNC00002286	317	+	75	74	-304.0	-304.0	-304.0
chrX	48685633	48685945	48685583	48685971	JUNC00002287	1	+	50	26	-304.0	-304.0	-304.0
chrX	48685836	48685945	48685761	48685987	JUNC00002288	255	+	75	42	-304.0	-304.0	-304.0
chrX	48685987	48686080	48685943	48686135	JUNC00002289	269	+	44	55	-304.0	-304.0	-304.0
chrX	48686134	48686780	48686078	48686855	JUNC00002290	336	+	56	75	-304.0	-304.0	-304.0
chrX	48686134	48688299	48686080	48688327	JUNC00002291	2	+	54	28	-304.0	-304.0	-304.0
chrX	48686172	48686780	48686125	48686855	JUNC00002292	4	+	47	75	-304.0	-304.0	-304.0
chrX	48686955	48688053	48686880	48688125	JUNC00002293	370	+	75	72	-304.0	-304.0	-304.0
chrX	48688096	48688299	48688053	48688374	JUNC00002294	273	+	43	75	-304.0	-304.0	-304.0
chrX	48688096	48688318	48688053	48688387	JUNC00002295	3	+	43	69	-304.0	-304.0	-304.0
chrX	48688453	48688659	48688379	48688734	JUNC00002296	88	+	74	75	-304.0	-304.0	-304.0
chrX	48689066	48689319	48688991	48689394	JUNC00002298	203	+	75	75	-304.0	-304.0	-304.0
chrX	48689066	48691106	48688991	48691181	JUNC00002297	3	+	75	75	-304.0	-304.0	-304.0
chrX	48689359	48691220	48689335	48691291	JUNC00002299	2	-	24	71	-304.0	-304.0	-304.0
chrX	48689434	48690149	48689359	48690222	JUNC00002301	17	+	75	73	-304.0	-304.0	-304.0
chrX	48689434	48691106	48689359	48691181	JUNC00002300	323	+	75	75	-304.0	-304.0	-304.0
chrX	48696803	48698901	48696731	48698974	JUNC00002302	35	+	72	73	-304.0	-304.0	-304.0
chrX	48699047	48700090	48698972	48700165	JUNC00002303	51	+	75	75	-304.0	-304.0	-304.0
chrX	48700753	48706264	48700682	48706334	JUNC00002304	50	+	71	70	-304.0	-304.0	-304.0
chrX	48706411	48706497	48706336	48706572	JUNC00002305	57	+	75	75	-304.0	-304.0	-304.0
chrX	48706627	48707436	48706554	48707511	JUNC00002306	66	+	73	75	-304.0	-304.0	-304.0
chrX	48723153	48770061	48723118	48770102	JUNC00002307	1	+	35	41	-304.0	-304.0	-304.0
chrX	48733042	48807744	48733027	48807805	JUNC00002308	1	-	15	61	-304.0	122.0	122.0
chrX	48743372	48767632	48743356	48767692	JUNC00002309	1	-	16	60	-304.0	-304.0	-304.0
chrX	48801431	48801873	48801399	48801942	JUNC00002310	2	+	32	69	-304.0	-304.0	-304.0
chrX	48802235	48802662	48802194	48802726	JUNC00002311	4	+	41	64	-304.0	-304.0	-304.0
chrX	48802272	48802662	48802209	48802735	JUNC00002312	13	+	63	73	-304.0	-304.0	-304.0
chrX	48802785	48802870	48802711	48802943	JUNC00002313	58	+	74	73	-304.0	-304.0	-304.0
chrX	48802999	48803127	48802924	48803199	JUNC00002314	62	+	75	72	-304.0	-304.0	-304.0
chrX	48803216	48805437	48803148	48805511	JUNC00002315	56	+	68	74	-304.0	-304.0	-304.0
chrX	48805522	48805630	48805448	48805671	JUNC00002316	48	+	74	41	-304.0	-304.0	-304.0
chrX	48805671	48806367	48805629	48806442	JUNC00002317	49	+	42	75	-304.0	-304.0	-304.0
chrX	48806464	48806608	48806390	48806672	JUNC00002318	37	+	74	64	-304.0	-304.0	-304.0
chrX	48806706	48808032	48806633	48808107	JUNC00002319	49	+	73	75	-304.0	-304.0	-304.0
chrX	48808137	48808257	48808062	48808326	JUNC00002320	48	+	75	69	-304.0	-304.0	-304.0
chrX	48808326	48814439	48808255	48814514	JUNC00002321	68	+	71	75	-304.0	-304.0	-304.0
chrX	48814474	48814833	48814444	48814879	JUNC00002322	1	+	30	46	-304.0	-304.0	-304.0
chrX	48814566	48814674	48814491	48814740	JUNC00002323	54	+	75	66	-304.0	-304.0	-304.0
chrX	48814740	48814833	48814674	48814893	JUNC00002324	45	+	66	60	-304.0	-304.0	-304.0
chrX	48814893	48814961	48814829	48815036	JUNC00002325	42	+	64	75	-304.0	-304.0	-304.0
chrX	48815051	48815383	48814980	48815457	JUNC00002326	32	+	71	74	-304.0	-304.0	-304.0
chrX	48815490	48815574	48815416	48815643	JUNC00002327	57	+	74	69	-304.0	-304.0	-304.0
chrX	48815642	48815883	48815573	48815954	JUNC00002328	65	+	69	71	-304.0	-304.0	-304.0
chrX	48816052	48816140	48815979	48816209	JUNC00002329	28	+	73	69	-304.0	-304.0	-304.0
chrX	48816269	48816464	48816201	48816526	JUNC00002330	17	+	68	62	-304.0	-304.0	-304.0
chrX	48816633	48817325	48816559	48817396	JUNC00002331	31	+	74	71	-304.0	-304.0	-304.0
chrX	48816633	48818040	48816595	48818101	JUNC00002332	2	+	38	61	-304.0	-304.0	-304.0
chrX	48817459	48818040	48817386	48818109	JUNC00002333	30	+	73	69	-304.0	-304.0	-304.0
chrX	48818109	48818219	48818040	48818292	JUNC00002334	25	+	69	73	-304.0	-304.0	-304.0
chrX	48818412	48820105	48818339	48820180	JUNC00002335	41	+	73	75	-304.0	-304.0	-304.0
chrX	48820255	48822619	48820194	48822693	JUNC00002336	48	+	61	74	-304.0	-304.0	-304.0
chrX	48822794	48822911	48822722	48822986	JUNC00002337	57	+	72	75	-304.0	-304.0	-304.0
chrX	48823588	48823671	48823513	48823744	JUNC00002338	67	+	75	73	-304.0	-304.0	-304.0
chrX	48823785	48823921	48823710	48823996	JUNC00002339	42	+	75	75	-304.0	-304.0	-304.0
chrX	48823785	48824543	48823710	48824617	JUNC00002340	7	+	75	74	-304.0	-304.0	-304.0
chrX	48824047	48824165	48824027	48824221	JUNC00002342	1	+	20	56	-304.0	-304.0	-304.0
chrX	48824068	48824165	48823994	48824239	JUNC00002341	57	+	74	74	-304.0	-304.0	-304.0
chrX	48824068	48824543	48824035	48824586	JUNC00002343	1	+	33	43	-304.0	-304.0	-304.0
chrX	48824294	48824543	48824223	48824617	JUNC00002344	71	+	71	74	-304.0	-304.0	-304.0
chrX	48893817	48893899	48893742	48893974	JUNC00002345	216	-	75	75	-304.0	-304.0	-304.0
chrX	48893917	48894096	48893899	48894139	JUNC00002346	1	-	18	43	-304.0	-304.0	-304.0
chrX	48894010	48894096	48893935	48894171	JUNC00002347	164	-	75	75	-304.0	-304.0	-304.0
chrX	48894225	48895037	48894152	48895101	JUNC00002348	267	-	73	64	-304.0	-304.0	-304.0
chrX	48895101	48895347	48895059	48895381	JUNC00002351	1	-	42	34	-304.0	-304.0	-304.0
chrX	48895101	48895351	48895037	48895425	JUNC00002350	23	-	64	74	-304.0	-304.0	-304.0
chrX	48895101	48896758	48895035	48896833	JUNC00002349	322	-	66	75	-304.0	-304.0	-304.0
chrX	48895454	48896758	48895411	48896807	JUNC00002352	3	-	43	49	-304.0	-304.0	-304.0
chrX	48895496	48896758	48895462	48896800	JUNC00002354	1	-	34	42	-304.0	-304.0	-304.0
chrX	48895501	48896758	48895427	48896832	JUNC00002353	25	-	74	74	-304.0	-304.0	-304.0
chrX	48896858	48897723	48896784	48897777	JUNC00002355	166	-	74	54	-304.0	-304.0	-304.0
chrX	48898014	48898491	48897943	48898566	JUNC00002356	59	+	71	75	-304.0	-304.0	-304.0
chrX	48898082	48898491	48898007	48898566	JUNC00002357	163	+	75	75	-304.0	-304.0	-304.0
chrX	48898082	48901189	48898014	48901264	JUNC00002358	4	+	68	75	-304.0	-304.0	-304.0
chrX	48898093	48898491	48898021	48898566	JUNC00002359	19	+	72	75	-304.0	-304.0	-304.0
chrX	48898350	48898491	48898312	48898529	JUNC00002360	2	+	38	38	-304.0	-304.0	-304.0
chrX	48898576	48901189	48898502	48901264	JUNC00002361	222	+	74	75	-304.0	-304.0	-304.0
chrX	48898576	48901195	48898539	48901270	JUNC00002362	2	+	37	75	-304.0	-304.0	-304.0
chrX	48898887	48986473	48898851	48986513	JUNC00002363	1	-	36	40	-304.0	-304.0	-304.0
chrX	48901253	48901929	48901223	48902004	JUNC00002364	2	+	30	75	-304.0	-304.0	-304.0
chrX	48901301	48901518	48901226	48901566	JUNC00002366	3	+	75	48	-304.0	-304.0	-304.0
chrX	48901301	48901797	48901269	48901841	JUNC00002367	1	+	32	44	-304.0	-304.0	-304.0
chrX	48901301	48901929	48901226	48902004	JUNC00002365	202	+	75	75	-304.0	-304.0	-304.0
chrX	48901311	48901929	48901282	48901966	JUNC00002368	1	+	29	37	-304.0	-304.0	-304.0
chrX	48902042	48902232	48901967	48902307	JUNC00002369	268	+	75	75	-304.0	-304.0	-304.0
chrX	48902042	48902731	48901980	48902795	JUNC00002370	7	+	62	64	-304.0	-304.0	-304.0
chrX	48902042	48902927	48901994	48902955	JUNC00002371	1	+	48	28	-304.0	-304.0	-304.0
chrX	48902384	48902731	48902318	48902791	JUNC00002373	13	+	66	60	-304.0	-304.0	-304.0
chrX	48902517	48902731	48902442	48902796	JUNC00002374	220	+	75	65	-304.0	-304.0	-304.0
chrX	48902517	48902734	48902442	48902795	JUNC00002375	11	+	75	61	-304.0	-304.0	-304.0
chrX	48902795	48902927	48902722	48903000	JUNC00002372	212	+	73	73	-304.0	-304.0	-304.0
chrX	48903465	48904745	48903430	48904786	JUNC00002376	1	-	35	41	-304.0	-304.0	-304.0
chrX	48903672	48904745	48903641	48904820	JUNC00002377	3	-	31	75	-304.0	-304.0	-304.0
chrX	48904892	48906391	48904844	48906445	JUNC00002378	8	-	48	54	-304.0	-304.0	-304.0
chrX	48905482	48906391	48905413	48906466	JUNC00002379	39	-	69	75	-304.0	-304.0	-304.0
chrX	48906543	48909813	48906470	48909878	JUNC00002380	40	-	73	65	-304.0	-304.0	-304.0
chrX	48909996	48911545	48909923	48911600	JUNC00002381	15	-	73	55	-304.0	-304.0	-304.0
chrX	48914294	48914394	48914219	48914469	JUNC00002382	413	-	75	75	-304.0	-304.0	-304.0
chrX	48914294	48915019	48914219	48915091	JUNC00002383	4	-	75	72	-304.0	-304.0	-304.0
chrX	48914571	48915019	48914496	48915094	JUNC00002384	358	-	75	75	-304.0	-304.0	-304.0
chrX	48915388	48917780	48915353	48917831	JUNC00002386	2	-	35	51	-304.0	-304.0	-304.0
chrX	48915392	48917780	48915317	48917837	JUNC00002385	174	-	75	57	-304.0	-304.0	-304.0
chrX	48917831	48918535	48917758	48918610	JUNC00002387	165	-	73	75	-304.0	-304.0	-304.0
chrX	48918645	48918773	48918571	48918843	JUNC00002388	64	-	74	70	-304.0	-304.0	-304.0
chrX	48922910	48923120	48922835	48923195	JUNC00002389	19	-	75	75	-304.0	-304.0	-304.0
chrX	48922910	48923136	48922845	48923211	JUNC00002390	49	-	65	75	-304.0	-304.0	-304.0
chrX	48923295	48923632	48923222	48923707	JUNC00002391	129	-	73	75	-304.0	-304.0	-304.0
chrX	48923298	48923632	48923225	48923707	JUNC00002392	33	-	73	75	-304.0	-304.0	-304.0
chrX	48923746	48923850	48923671	48923925	JUNC00002393	153	-	75	75	-304.0	-304.0	-304.0
chrX	48924052	48925846	48923979	48925921	JUNC00002394	58	-	73	75	-304.0	-304.0	-304.0
chrX	48926050	48934463	48925976	48934536	JUNC00002395	145	-	74	73	-304.0	-304.0	-304.0
chrX	48932023	48951489	48932008	48951550	JUNC00002396	1	-	15	61	-304.0	-304.0	-304.0
chrX	48934612	48934695	48934537	48934755	JUNC00002397	11	-	75	60	-304.0	-304.0	-304.0
chrX	48934612	48934710	48934537	48934785	JUNC00002398	197	-	75	75	-304.0	-304.0	-304.0
chrX	48934867	48934953	48934792	48935020	JUNC00002399	223	-	75	67	-304.0	-304.0	-304.0
chrX	48935018	48936190	48934980	48936228	JUNC00002401	1	-	38	38	-304.0	-304.0	-304.0
chrX	48935018	48944189	48934953	48944262	JUNC00002400	155	-	65	73	-304.0	-304.0	-304.0
chrX	48936358	48944189	48936300	48944207	JUNC00002402	1	-	58	18	-304.0	-304.0	-304.0
chrX	48944283	48956976	48944208	48957050	JUNC00002404	113	-	75	74	-304.0	-304.0	-304.0
chrX	48944283	48958231	48944208	48958301	JUNC00002403	7	-	75	70	-304.0	-304.0	-304.0
chrX	48954721	48956976	48954685	48957016	JUNC00002405	1	-	36	40	-304.0	-304.0	-304.0
chrX	48962905	48977609	48962868	48977648	JUNC00002406	1	+	37	39	-304.0	-304.0	-304.0
chrX	48966676	48966760	48966607	48966831	JUNC00002407	4	-	69	71	-304.0	-304.0	-304.0
chrX	48966844	48966943	48966804	48966979	JUNC00002408	1	-	40	36	-304.0	-304.0	-304.0
chrX	48967106	48969150	48967057	48969182	JUNC00002409	2	-	49	32	-304.0	-304.0	-304.0
chrX	48975291	48976017	48975217	48976086	JUNC00002410	7	-	74	69	-304.0	-304.0	-304.0
chrX	48975309	48976017	48975236	48976091	JUNC00002411	79	-	73	74	-304.0	-304.0	-304.0
chrX	48976111	48976240	48976036	48976314	JUNC00002412	91	-	75	74	-304.0	-304.0	-304.0
chrX	48976363	48978304	48976291	48978379	JUNC00002413	126	-	72	75	-304.0	-304.0	-304.0
chrX	48978435	48981214	48978360	48981283	JUNC00002414	132	-	75	69	-304.0	-304.0	-304.0
chrX	48978729	48981214	48978681	48981242	JUNC00002415	1	-	48	28	-304.0	-304.0	-304.0
chrX	48980670	48986027	48980651	48986084	JUNC00002416	1	+	19	57	-304.0	-304.0	-304.0
chrX	48981314	48981415	48981239	48981475	JUNC00002417	175	-	75	60	-304.0	-304.0	-304.0
chrX	48981472	48981595	48981415	48981667	JUNC00002418	149	-	57	72	-304.0	-304.0	-304.0
chrX	48981691	48981794	48981616	48981868	JUNC00002419	169	-	75	74	-304.0	-304.0	-304.0
chrX	48981691	48982978	48981616	48983053	JUNC00002420	8	-	75	75	-304.0	-304.0	-304.0
chrX	48981872	48982978	48981797	48983053	JUNC00002421	132	-	75	75	-304.0	-304.0	-304.0
chrX	48981872	48983035	48981797	48983093	JUNC00002422	4	-	75	58	-304.0	-304.0	-304.0
chrX	48983092	48983227	48983017	48983301	JUNC00002423	128	-	75	74	-304.0	-304.0	-304.0
chrX	48983438	48983774	48983363	48983821	JUNC00002424	5	-	75	47	-304.0	-304.0	-304.0
chrX	48983440	48983774	48983367	48983849	JUNC00002425	192	-	73	75	-304.0	-304.0	-304.0
chrX	48983470	48983774	48983434	48983829	JUNC00002426	3	-	36	55	-304.0	-304.0	-304.0
chrX	48983870	48985267	48983795	48985342	JUNC00002427	170	-	75	75	-304.0	-304.0	-304.0
chrX	48985402	48986164	48985335	48986213	JUNC00002429	3	-	67	49	-304.0	-304.0	-304.0
chrX	48985402	48987784	48985330	48987858	JUNC00002428	177	-	72	74	-304.0	-304.0	-304.0
chrX	48986239	48987784	48986193	48987817	JUNC00002430	2	-	46	33	-304.0	-304.0	-304.0
chrX	48987877	48988120	48987802	48988194	JUNC00002431	145	-	75	74	-304.0	-304.0	-304.0
chrX	48988198	48989610	48988123	48989685	JUNC00002432	136	-	75	75	-304.0	-304.0	-304.0
chrX	48989710	48989834	48989635	48989884	JUNC00002433	143	-	75	50	-304.0	-304.0	-304.0
chrX	48989882	48989971	48989833	48990039	JUNC00002434	125	-	49	68	-304.0	-304.0	-304.0
chrX	48990003	48990684	48989971	48990734	JUNC00002435	137	-	32	50	-304.0	-304.0	-304.0
chrX	48990732	48990925	48990684	48991000	JUNC00002436	120	-	48	75	-304.0	-304.0	-304.0
chrX	48991110	48993427	48991038	48993501	JUNC00002437	73	-	72	74	-304.0	-304.0	-304.0
chrX	48993578	48997249	48993505	48997320	JUNC00002438	139	-	73	71	-304.0	-304.0	-304.0
chrX	48993578	48999237	48993551	48999286	JUNC00002439	2	-	27	49	-304.0	-304.0	-304.0
chrX	48997357	48998153	48997282	48998191	JUNC00002440	126	-	75	38	-304.0	-304.0	-304.0
chrX	48997916	48997993	48997876	48998029	JUNC00002442	1	?	40	36	-304.0	-304.0	-304.0
chrX	48998180	48999237	48998153	48999299	JUNC00002441	97	-	27	62	-304.0	-304.0	-304.0
chrX	48999299	48999437	48999237	48999504	JUNC00002443	109	-	62	67	-304.0	-304.0	-304.0
chrX	48999504	49000565	48999437	49000618	JUNC00002444	6	-	67	53	-304.0	-304.0	-304.0
chrX	48999504	49000860	48999448	49000915	JUNC00002446	3	-	56	55	-304.0	-304.0	-304.0
chrX	48999504	49002187	48999437	49002254	JUNC00002445	70	-	67	67	-304.0	-304.0	-304.0
chrX	49002425	49024810	49002384	49024845	JUNC00002447	1	+	41	35	-304.0	-304.0	-304.0
chrX	49018594	49051953	49018569	49052004	JUNC00002448	1	+	25	51	-304.0	-304.0	-304.0
chrX	49029121	49029944	49029065	49029964	JUNC00002449	1	-	56	20	-304.0	-304.0	-304.0
chrX	49030601	49031396	49030527	49031471	JUNC00002450	69	-	74	75	-304.0	-304.0	-304.0
chrX	49030601	49033464	49030570	49033509	JUNC00002451	1	-	31	45	-304.0	-304.0	-304.0
chrX	49031544	49033135	49031493	49033181	JUNC00002453	3	-	51	46	-304.0	-304.0	-304.0
chrX	49031544	49033464	49031469	49033539	JUNC00002452	107	-	75	75	-304.0	-304.0	-304.0
chrX	49033181	49033464	49033134	49033493	JUNC00002454	3	-	47	29	-304.0	-304.0	-304.0
chrX	49033540	49033725	49033465	49033783	JUNC00002455	121	-	75	58	-304.0	-304.0	-304.0
chrX	49033782	49034133	49033725	49034207	JUNC00002456	150	-	57	74	-304.0	-304.0	-304.0
chrX	49034251	49034462	49034176	49034503	JUNC00002458	3	-	75	41	-304.0	-304.0	-304.0
chrX	49034251	49038009	49034176	49038084	JUNC00002457	100	-	75	75	-304.0	-304.0	-304.0
chrX	49036774	49038009	49036717	49038084	JUNC00002459	5	-	57	75	-304.0	-304.0	-304.0
chrX	49038114	49038196	49038039	49038267	JUNC00002460	37	-	75	71	-304.0	-304.0	-304.0
chrX	49038442	49039106	49038367	49039178	JUNC00002461	45	-	75	72	-304.0	-304.0	-304.0
chrX	49039345	49040454	49039271	49040520	JUNC00002462	19	-	74	66	-304.0	-304.0	-304.0
chrX	49039391	49040454	49039318	49040510	JUNC00002463	3	-	73	56	-304.0	-304.0	-304.0
chrX	49039410	49040454	49039337	49040527	JUNC00002464	61	-	73	73	-304.0	-304.0	-304.0
chrX	49040568	49043110	49040497	49043183	JUNC00002465	51	-	71	73	-304.0	-304.0	-304.0
chrX	49053877	49061958	49053825	49062001	JUNC00002466	3	+	52	43	-304.0	-304.0	-304.0
chrX	49062001	49062234	49061958	49062280	JUNC00002467	3	+	43	46	-304.0	-304.0	-304.0
chrX	49062117	49062234	49062043	49062306	JUNC00002468	7	+	74	72	-304.0	-304.0	-304.0
chrX	49062289	49062467	49062265	49062519	JUNC00002470	1	+	24	52	-304.0	-304.0	-304.0
chrX	49062325	49062467	49062251	49062538	JUNC00002469	13	+	74	71	-304.0	-304.0	-304.0
chrX	49062325	49065453	49062299	49065503	JUNC00002471	1	+	26	50	-304.0	-304.0	-304.0
chrX	49065098	49065453	49065037	49065524	JUNC00002472	4	+	61	71	-304.0	-304.0	-304.0
chrX	49065628	49065746	49065572	49065800	JUNC00002473	4	+	56	54	-304.0	-304.0	-304.0
chrX	49065845	49067175	49065786	49067236	JUNC00002474	2	+	59	61	-304.0	-304.0	-304.0
chrX	49072008	49072379	49071954	49072401	JUNC00002476	1	-	54	22	-304.0	-304.0	-304.0
chrX	49072008	49072432	49071933	49072473	JUNC00002475	6	-	75	41	-304.0	-304.0	-304.0
chrX	49072650	49073808	49072583	49073874	JUNC00002477	5	-	67	66	-304.0	-304.0	-304.0
chrX	49074912	49075135	49074837	49075200	JUNC00002478	55	-	75	65	-304.0	-304.0	-304.0
chrX	49074912	49075363	49074893	49075420	JUNC00002479	1	-	19	57	-304.0	-304.0	-304.0
chrX	49075281	49075363	49075216	49075408	JUNC00002480	8	-	65	45	-304.0	-304.0	-304.0
chrX	49075465	49075544	49075397	49075619	JUNC00002481	45	-	68	75	-304.0	-304.0	-304.0
chrX	49075663	49075865	49075645	49075923	JUNC00002482	1	-	18	58	-304.0	-304.0	-304.0
chrX	49075753	49075865	49075679	49075934	JUNC00002483	72	-	74	69	-304.0	-304.0	-304.0
chrX	49075945	49076429	49075872	49076504	JUNC00002484	68	-	73	75	-304.0	-304.0	-304.0
chrX	49075978	49076429	49075943	49076470	JUNC00002485	1	-	35	41	-304.0	-304.0	-304.0
chrX	49076524	49076644	49076450	49076719	JUNC00002486	74	-	74	75	-304.0	-304.0	-304.0
chrX	49076750	49076850	49076732	49076908	JUNC00002489	1	-	18	58	-304.0	-304.0	-304.0
chrX	49076750	49077642	49076680	49077717	JUNC00002487	51	-	70	75	-304.0	-304.0	-304.0
chrX	49076753	49077642	49076680	49077712	JUNC00002488	5	-	73	70	-304.0	-304.0	-304.0
chrX	49077747	49077836	49077677	49077911	JUNC00002490	40	-	70	75	-304.0	-304.0	-304.0
chrX	49077911	49078040	49077840	49078113	JUNC00002491	65	-	71	73	-304.0	-304.0	-304.0
chrX	49078112	49079750	49078040	49079817	JUNC00002492	38	-	72	67	-304.0	-304.0	-304.0
chrX	49078112	49079938	49078046	49080001	JUNC00002493	7	-	66	63	-304.0	-304.0	-304.0
chrX	49078112	49100581	49078085	49100630	JUNC00002494	1	-	27	49	-304.0	-304.0	-304.0
chrX	49100677	49101049	49100620	49101115	JUNC00002495	3	-	57	66	-304.0	-304.0	-304.0
chrX	49113755	49113852	49113680	49113925	JUNC00002496	107	-	75	73	-304.0	-304.0	-304.0
chrX	49113938	49115725	49113864	49115795	JUNC00002497	97	-	74	70	-304.0	-304.0	-304.0
chrX	49115795	49115890	49115724	49115961	JUNC00002498	84	-	71	71	-304.0	-304.0	-304.0
chrX	49116014	49116220	49115940	49116295	JUNC00002499	123	-	74	75	-304.0	-304.0	-304.0
chrX	49116323	49117029	49116248	49117104	JUNC00002500	132	-	75	75	-304.0	-304.0	-304.0
chrX	49117162	49117596	49117088	49117671	JUNC00002501	94	-	74	75	-304.0	-304.0	-304.0
chrX	49117810	49119704	49117735	49119778	JUNC00002502	61	-	75	74	-304.0	-304.0	-304.0
chrX	49119814	49122397	49119739	49122472	JUNC00002503	58	-	75	75	-304.0	-304.0	-304.0
chrX	49122522	49122621	49122450	49122693	JUNC00002504	58	-	72	72	-304.0	-304.0	-304.0
chrX	49122776	49123546	49122706	49123619	JUNC00002505	26	-	70	73	-304.0	-304.0	-304.0
chrX	49142342	49148383	49142302	49148419	JUNC00002506	1	-	40	36	-304.0	-304.0	-304.0
chrX	49142360	49142720	49142313	49142745	JUNC00002507	1	-	47	25	-304.0	-304.0	-304.0
chrX	49165361	49166088	49165288	49166144	JUNC00002508	2	+	73	56	-304.0	-304.0	-304.0
chrX	49166694	49173128	49166674	49173184	JUNC00002509	1	+	20	56	-304.0	-304.0	-304.0
chrX	49171958	49173128	49171933	49173179	JUNC00002510	1	+	25	51	-304.0	-304.0	-304.0
chrX	49172096	49173128	49172022	49173202	JUNC00002511	374	+	74	74	-304.0	-304.0	-304.0
chrX	49173281	49173387	49173206	49173462	JUNC00002512	515	+	75	75	-304.0	-304.0	-304.0
chrX	49173281	49174334	49173206	49174366	JUNC00002513	4	+	75	32	-304.0	-304.0	-304.0
chrX	49173483	49174334	49173408	49174408	JUNC00002514	437	+	75	74	-304.0	-304.0	-304.0
chrX	49174425	49174671	49174350	49174746	JUNC00002515	506	+	75	75	-304.0	-304.0	-304.0
chrX	49176265	49176902	49176206	49176970	JUNC00002516	10	-	59	68	-304.0	-304.0	-304.0
chrX	49177202	49177992	49177135	49178065	JUNC00002517	17	-	67	73	-304.0	-304.0	-304.0
chrX	49178179	49178271	49178105	49178344	JUNC00002518	43	-	74	73	-304.0	-304.0	-304.0
chrX	49178475	49179250	49178406	49179321	JUNC00002519	51	-	69	71	-304.0	-304.0	-304.0
chrX	49178475	49179610	49178453	49179662	JUNC00002520	1	-	22	52	-304.0	-304.0	-304.0
chrX	49179388	49179692	49179313	49179767	JUNC00002521	60	-	75	75	-304.0	-304.0	-304.0
chrX	49179806	49183656	49179731	49183687	JUNC00002523	3	-	75	31	-304.0	-304.0	-304.0
chrX	49179806	49183733	49179731	49183807	JUNC00002522	53	-	75	74	-304.0	-304.0	-304.0
chrX	49179836	49183733	49179820	49183793	JUNC00002524	1	-	16	60	-304.0	-304.0	-304.0
chrX	49183917	49184624	49183842	49184698	JUNC00002525	28	-	75	74	-304.0	-304.0	-304.0
chrX	49184710	49184825	49184692	49184883	JUNC00002527	1	-	18	58	-304.0	-304.0	-304.0
chrX	49184710	49186255	49184650	49186272	JUNC00002526	2	-	60	17	-304.0	-304.0	-304.0
chrX	49197839	49198967	49197817	49199021	JUNC00002528	1	-	22	54	-304.0	-304.0	-304.0
chrX	49210042	49210300	49210021	49210355	JUNC00002529	1	-	21	55	-304.0	-304.0	-304.0
chrX	49212795	49213818	49212735	49213893	JUNC00002530	2	-	60	75	-304.0	-304.0	-304.0
chrX	49235686	49237085	49235613	49237160	JUNC00002531	46	+	73	75	-304.0	-304.0	-304.0
chrX	49237263	49242015	49237191	49242088	JUNC00002532	52	+	72	73	-304.0	-304.0	-304.0
chrX	49242148	49242641	49242125	49242694	JUNC00002534	1	+	23	53	-304.0	-304.0	-304.0
chrX	49242148	49242885	49242077	49242957	JUNC00002533	64	+	71	72	-304.0	-304.0	-304.0
chrX	49242992	49243117	49242917	49243184	JUNC00002535	68	+	75	67	-304.0	-304.0	-304.0
chrX	49243181	49243283	49243144	49243349	JUNC00002537	6	+	37	66	-304.0	-304.0	-304.0
chrX	49243184	49243283	49243117	49243351	JUNC00002536	35	+	67	68	-304.0	-304.0	-304.0
chrX	49243462	49246730	49243387	49246801	JUNC00002538	23	+	75	71	-304.0	-304.0	-304.0
chrX	49246925	49247495	49246856	49247558	JUNC00002539	45	+	69	63	-304.0	-304.0	-304.0
chrX	49247558	49247648	49247494	49247723	JUNC00002540	64	+	64	75	-304.0	-304.0	-304.0
chrX	49247768	49248190	49247693	49248256	JUNC00002541	39	+	75	66	-304.0	-304.0	-304.0
chrX	49247768	49248194	49247726	49248269	JUNC00002542	2	+	42	75	-304.0	-304.0	-304.0
chrX	49248310	49248406	49248236	49248476	JUNC00002543	37	+	74	70	-304.0	-304.0	-304.0
chrX	49248523	49248632	49248449	49248707	JUNC00002544	68	+	74	75	-304.0	-304.0	-304.0
chrX	49248734	49248816	49248661	49248891	JUNC00002545	82	+	73	75	-304.0	-304.0	-304.0
chrX	49248924	49249166	49248850	49249239	JUNC00002546	124	+	74	73	-304.0	-304.0	-304.0
chrX	49249238	49249508	49249164	49249568	JUNC00002547	11	+	74	60	-304.0	-304.0	-304.0
chrX	49249262	49249508	49249188	49249568	JUNC00002548	140	+	74	60	-304.0	-304.0	-304.0
chrX	49249568	49249650	49249508	49249724	JUNC00002549	117	+	60	74	-304.0	-304.0	-304.0
chrX	49249725	49250147	49249652	49250222	JUNC00002550	74	+	73	75	-304.0	-304.0	-304.0
chrX	49251483	49251663	49251453	49251709	JUNC00002551	1	-	30	46	-304.0	-304.0	-304.0
chrX	49251765	49253125	49251706	49253142	JUNC00002552	1	-	59	17	-304.0	-304.0	-304.0
chrX	49255802	49256750	49255784	49256804	JUNC00002553	1	-	18	54	-304.0	-304.0	-304.0
chrX	49257523	49257663	49257480	49257696	JUNC00002554	1	-	43	33	-304.0	-304.0	-304.0
chrX	49257768	49258295	49257740	49258343	JUNC00002555	1	-	28	48	-304.0	-304.0	-304.0
chrX	49270873	49281405	49270803	49281461	JUNC00002556	6	+	70	56	-304.0	-304.0	-304.0
chrX	49281461	49281980	49281405	49282051	JUNC00002557	12	+	56	71	-304.0	-304.0	-304.0
chrX	49281461	49281983	49281417	49282057	JUNC00002558	5	+	44	74	-304.0	-304.0	-304.0
chrX	49282063	49285833	49282004	49285895	JUNC00002560	6	+	59	62	-304.0	-304.0	-304.0
chrX	49282063	49299275	49281989	49299343	JUNC00002559	7	+	74	68	-304.0	-304.0	-304.0
chrX	49299435	49301350	49299372	49301385	JUNC00002561	3	+	63	35	-304.0	-304.0	-304.0
chrX	49305524	49313693	49305482	49313727	JUNC00002562	1	+	42	34	-304.0	-304.0	-304.0
chrX	49878747	49879090	49878701	49879159	JUNC00002563	2	-	46	69	-304.0	-304.0	-304.0
chrX	49922792	49923406	49922754	49923476	JUNC00002564	2	+	38	70	-304.0	-304.0	-304.0
chrX	49923482	49925170	49923447	49925232	JUNC00002565	2	+	35	62	-304.0	-304.0	-304.0
chrX	49923741	49925170	49923698	49925212	JUNC00002566	2	+	43	42	-304.0	-304.0	-304.0
chrX	49925314	50042315	49925252	50042367	JUNC00002567	3	+	62	52	-304.0	-304.0	-304.0
chrX	50070030	50072488	50069967	50072523	JUNC00002568	6	+	63	35	-304.0	-304.0	-304.0
chrX	50072588	50075794	50072557	50075839	JUNC00002569	2	+	31	45	-304.0	-304.0	-304.0
chrX	50075982	50080593	50075910	50080648	JUNC00002570	3	+	72	55	-304.0	-304.0	-304.0
chrX	50081847	50085979	50081802	50086010	JUNC00002571	1	+	45	31	-304.0	-304.0	-304.0
chrX	50086060	50086327	50086022	50086384	JUNC00002572	4	+	38	57	-304.0	-304.0	-304.0
chrX	50088884	50090115	50088821	50090183	JUNC00002573	5	+	63	68	-304.0	-304.0	-304.0
chrX	50090514	50090669	50090479	50090710	JUNC00002574	1	+	35	41	-304.0	-304.0	-304.0
chrX	50090886	50092128	50090812	50092198	JUNC00002575	10	+	74	70	-304.0	-304.0	-304.0
chrX	50209610	50324301	50209570	50324337	JUNC00002576	1	-	40	36	-304.0	-304.0	-304.0
chrX	50288887	50294862	50288834	50294903	JUNC00002577	3	+	53	41	-304.0	-304.0	-304.0
chrX	50294993	50308504	50294969	50308556	JUNC00002578	1	+	24	52	-304.0	-304.0	-304.0
chrX	50346807	50347625	50346762	50347665	JUNC00002579	2	+	45	40	-304.0	-304.0	-304.0
chrX	51803117	51819351	51803079	51819404	JUNC00002582	6	+	38	53	-304.0	-304.0	-304.0
chrX	51803117	51884981	51803090	51885036	JUNC00002583	3	+	27	55	-304.0	-304.0	-304.0
chrX	51803117	51894268	51803058	51894340	JUNC00002580	35	+	59	72	-304.0	-304.0	-304.0
chrX	51803117	51895052	51803075	51895127	JUNC00002581	5	+	42	75	-304.0	-304.0	-304.0
chrX	51816083	51819351	51816053	51819408	JUNC00002584	2	+	30	57	-304.0	-304.0	-304.0
chrX	51819408	51884981	51819350	51885017	JUNC00002585	4	+	58	36	-304.0	-304.0	-304.0
chrX	51855668	51900181	51855649	51900234	JUNC00002586	1	+	19	53	-304.0	-304.0	-304.0
chrX	51885055	51894268	51885001	51894340	JUNC00002587	3	+	54	72	-304.0	-304.0	-304.0
chrX	51893755	51894268	51893683	51894340	JUNC00002588	151	+	72	72	-304.0	-304.0	-304.0
chrX	51894349	51895052	51894274	51895127	JUNC00002589	253	+	75	75	-304.0	-304.0	-304.0
chrX	51894598	51895052	51894569	51895127	JUNC00002590	3	+	29	75	-304.0	-304.0	-304.0
chrX	51894794	51895052	51894770	51895104	JUNC00002591	1	+	24	52	-304.0	-304.0	-304.0
chrX	51895760	51896408	51895685	51896483	JUNC00002592	254	+	75	75	-304.0	-304.0	-304.0
chrX	51896859	51896913	51896789	51896986	JUNC00002593	3	?	70	73	-304.0	-304.0	-304.0
chrX	51897077	51897207	51897003	51897271	JUNC00002594	287	+	74	64	-304.0	-304.0	-304.0
chrX	51897271	51897546	51897200	51897621	JUNC00002595	253	+	71	75	-304.0	-304.0	-304.0
chrX	51897626	51897794	51897551	51897869	JUNC00002596	268	+	75	75	-304.0	-304.0	-304.0
chrX	51897886	51898113	51897811	51898188	JUNC00002597	372	+	75	75	-304.0	-304.0	-304.0
chrX	51898193	51898284	51898118	51898348	JUNC00002598	305	+	75	64	-304.0	-304.0	-304.0
chrX	51898193	52189551	51898119	52189594	JUNC00002599	72	+	74	43	-304.0	-304.0	-304.0
chrX	51898327	51898580	51898283	51898643	JUNC00002600	252	+	44	63	-304.0	-304.0	-304.0
chrX	51898643	51900181	51898579	51900255	JUNC00002601	264	+	64	74	-304.0	-304.0	-304.0
chrX	51900296	51901552	51900223	51901627	JUNC00002602	351	+	73	75	-304.0	-304.0	-304.0
chrX	51901938	51902145	51901863	51902219	JUNC00002603	295	+	75	74	-304.0	-304.0	-304.0
chrX	52062038	52062221	52062001	52062260	JUNC00002605	1	-	37	39	-304.0	-304.0	-304.0
chrX	52062038	52062233	52061980	52062289	JUNC00002604	4	-	58	56	-304.0	-304.0	-304.0
chrX	52062664	52062986	52062607	52063049	JUNC00002606	5	-	57	63	-304.0	-304.0	-304.0
chrX	52063101	52063522	52063073	52063570	JUNC00002608	1	-	28	48	-304.0	-304.0	-304.0
chrX	52063101	52064046	52063070	52064098	JUNC00002607	3	-	31	52	-304.0	-304.0	-304.0
chrX	52064543	52064628	52064499	52064651	JUNC00002609	1	-	44	23	-304.0	-304.0	-304.0
chrX	52064708	52065329	52064661	52065362	JUNC00002610	2	-	47	33	-304.0	-304.0	-304.0
chrX	52065421	52065809	52065369	52065833	JUNC00002611	1	-	52	24	-304.0	-304.0	-304.0
chrX	52066453	52066864	52066387	52066917	JUNC00002612	3	-	66	53	-304.0	-304.0	-304.0
chrX	52067698	52067962	52067636	52068032	JUNC00002613	6	-	62	70	-304.0	-304.0	-304.0
chrX	52068173	52069129	52068133	52069165	JUNC00002614	1	-	40	36	-304.0	-304.0	-304.0
chrX	52068203	52069129	52068153	52069160	JUNC00002615	2	-	50	31	-304.0	-304.0	-304.0
chrX	52068224	52069129	52068170	52069192	JUNC00002616	3	-	54	63	-304.0	-304.0	-304.0
chrX	52184965	52185870	52184902	52185924	JUNC00002617	3	+	63	54	-304.0	-304.0	-304.0
chrX	52184965	52185891	52184934	52185941	JUNC00002619	2	+	31	50	-304.0	-304.0	-304.0
chrX	52184965	52185921	52184929	52185961	JUNC00002618	1	+	36	40	-304.0	-304.0	-304.0
chrX	52186132	52186396	52186062	52186458	JUNC00002620	6	+	70	62	-304.0	-304.0	-304.0
chrX	52187230	52187641	52187177	52187707	JUNC00002621	3	+	53	66	-304.0	-304.0	-304.0
chrX	52188285	52188673	52188261	52188725	JUNC00002622	1	+	24	52	-304.0	-304.0	-304.0
chrX	52188765	52189386	52188732	52189433	JUNC00002623	2	+	33	47	-304.0	-304.0	-304.0
chrX	52189466	52189551	52189443	52189595	JUNC00002624	1	+	23	44	-304.0	-304.0	-304.0
chrX	52190048	52190993	52189996	52191035	JUNC00002625	4	+	52	42	-304.0	-304.0	-304.0
chrX	52190572	52190993	52190524	52191021	JUNC00002626	1	+	48	28	-304.0	-304.0	-304.0
chrX	52191108	52191430	52191045	52191487	JUNC00002627	5	+	63	57	-304.0	-304.0	-304.0
chrX	52191861	52192056	52191805	52192114	JUNC00002628	4	+	56	58	-304.0	-304.0	-304.0
chrX	52191873	52192056	52191834	52192093	JUNC00002629	1	+	39	37	-304.0	-304.0	-304.0
chrX	52733570	52748745	52733526	52748777	JUNC00002630	1	+	44	32	-304.0	-304.0	-304.0
chrX	52897409	52899467	52897377	52899540	JUNC00002631	5	+	32	73	-304.0	-304.0	-304.0
chrX	52897471	52899467	52897454	52899526	JUNC00002632	1	+	17	59	-304.0	-304.0	-304.0
chrX	52897604	52897659	52897574	52897705	JUNC00002633	1	?	30	46	-304.0	-304.0	-304.0
chrX	52898726	52899058	52898689	52899133	JUNC00002634	3	+	37	75	-304.0	-304.0	-304.0
chrX	52899541	52900570	52899521	52900626	JUNC00002635	1	+	20	56	-304.0	-304.0	-304.0
chrX	52900660	52907108	52900588	52907183	JUNC00002636	60	+	72	75	-304.0	-304.0	-304.0
chrX	52924192	52929001	52924119	52929068	JUNC00002637	8	+	73	67	-304.0	-304.0	-304.0
chrX	52948705	52955153	52948630	52955225	JUNC00002638	73	-	75	72	-304.0	-304.0	-304.0
chrX	52955243	52956272	52955187	52956292	JUNC00002640	1	-	56	20	-304.0	-304.0	-304.0
chrX	52955246	52956272	52955171	52956347	JUNC00002639	72	-	75	75	-304.0	-304.0	-304.0
chrX	52956346	52957087	52956274	52957158	JUNC00002642	15	-	72	71	-304.0	-304.0	-304.0
chrX	52956346	52957601	52956318	52957649	JUNC00002645	1	-	28	48	-304.0	-304.0	-304.0
chrX	52956346	52958342	52956287	52958359	JUNC00002643	1	-	59	17	-304.0	-304.0	-304.0
chrX	52956346	52958404	52956273	52958463	JUNC00002641	9	-	73	59	-304.0	-304.0	-304.0
chrX	52956346	52995414	52956313	52995457	JUNC00002644	1	-	33	43	-304.0	-304.0	-304.0
chrX	52956755	52957087	52956680	52957124	JUNC00002646	3	-	75	37	-304.0	-304.0	-304.0
chrX	52958153	52958208	52958108	52958239	JUNC00002647	1	?	45	31	-304.0	-304.0	-304.0
chrX	53082666	53084754	53082596	53084812	JUNC00002648	2	+	70	58	-304.0	-304.0	-304.0
chrX	53083305	53084544	53083230	53084617	JUNC00002649	33	+	75	73	-304.0	-304.0	-304.0
chrX	53084622	53084754	53084547	53084828	JUNC00002650	42	+	75	74	-304.0	-304.0	-304.0
chrX	53084866	53084953	53084795	53085028	JUNC00002651	23	+	71	75	-304.0	-304.0	-304.0
chrX	53085099	53085226	53085027	53085298	JUNC00002652	35	+	72	72	-304.0	-304.0	-304.0
chrX	53085321	53085630	53085247	53085705	JUNC00002653	41	+	74	75	-304.0	-304.0	-304.0
chrX	53086310	53087775	53086236	53087850	JUNC00002654	68	+	74	75	-304.0	-304.0	-304.0
chrX	53094284	53094399	53094272	53094463	JUNC00002655	1	+	12	64	-304.0	-304.0	-304.0
chrX	53094474	53099471	53094401	53099537	JUNC00002656	7	+	73	66	-304.0	-304.0	-304.0
chrX	53115970	53131018	53115924	53131048	JUNC00002657	1	+	46	30	-304.0	-304.0	-304.0
chrX	53131127	53141847	53131075	53141911	JUNC00002658	2	+	52	64	-304.0	-304.0	-304.0
chrX	53163399	53216073	53163348	53216096	JUNC00002659	1	-	51	23	-304.0	-304.0	-304.0
chrX	53176622	53179744	53176586	53179784	JUNC00002660	1	-	36	40	-304.0	-304.0	-304.0
chrX	53192841	53192892	53192774	53192951	JUNC00002661	8	+	67	59	-304.0	-304.0	-304.0
chrX	53193332	53193436	53193269	53193508	JUNC00002662	82	-	63	72	-304.0	-304.0	-304.0
chrX	53193636	53193772	53193561	53193847	JUNC00002663	65	-	75	75	-304.0	-304.0	-304.0
chrX	53193636	53193781	53193561	53193851	JUNC00002664	80	-	75	70	-304.0	-304.0	-304.0
chrX	53193851	53194138	53193776	53194212	JUNC00002665	154	-	75	74	-304.0	-304.0	-304.0
chrX	53194738	53194930	53194663	53195004	JUNC00002666	152	-	75	74	-304.0	-304.0	-304.0
chrX	53195068	53195230	53194993	53195305	JUNC00002667	155	-	75	75	-304.0	-304.0	-304.0
chrX	53195068	53195308	53194993	53195383	JUNC00002668	13	-	75	75	-304.0	-304.0	-304.0
chrX	53195410	53195915	53195336	53195990	JUNC00002669	148	-	74	75	-304.0	-304.0	-304.0
chrX	53196054	53196685	53195979	53196760	JUNC00002670	115	-	75	75	-304.0	-304.0	-304.0
chrX	53197044	53197770	53196970	53197845	JUNC00002671	58	-	74	75	-304.0	-304.0	-304.0
chrX	53197876	53198489	53197802	53198564	JUNC00002672	82	-	74	75	-304.0	-304.0	-304.0
chrX	53198637	53198763	53198565	53198838	JUNC00002673	133	-	72	75	-304.0	-304.0	-304.0
chrX	53198888	53198976	53198814	53199051	JUNC00002674	162	-	74	75	-304.0	-304.0	-304.0
chrX	53199158	53201549	53199084	53201624	JUNC00002675	140	-	74	75	-304.0	-304.0	-304.0
chrX	53201744	53201853	53201669	53201927	JUNC00002676	141	-	75	74	-304.0	-304.0	-304.0
chrX	53201973	53210413	53201900	53210488	JUNC00002677	182	-	73	75	-304.0	-304.0	-304.0
chrX	53210576	53210675	53210501	53210750	JUNC00002678	137	-	75	75	-304.0	-304.0	-304.0
chrX	53210857	53211496	53210782	53211571	JUNC00002679	117	-	75	75	-304.0	-304.0	-304.0
chrX	53211655	53211786	53211580	53211861	JUNC00002680	149	-	75	75	-304.0	-304.0	-304.0
chrX	53211906	53214688	53211831	53214763	JUNC00002681	145	-	75	75	-304.0	-304.0	-304.0
chrX	53214847	53215426	53214793	53215448	JUNC00002683	1	-	54	22	-304.0	-304.0	-304.0
chrX	53214847	53215794	53214772	53215866	JUNC00002682	131	-	75	72	-304.0	-304.0	-304.0
chrX	53215976	53216073	53215901	53216148	JUNC00002684	116	-	75	75	-304.0	-304.0	-304.0
chrX	53215995	53216073	53215976	53216130	JUNC00002685	1	-	19	57	-304.0	-304.0	-304.0
chrX	53216197	53217142	53216125	53217215	JUNC00002686	113	-	72	73	-304.0	-304.0	-304.0
chrX	53217274	53217795	53217199	53217870	JUNC00002687	29	-	75	75	-304.0	-304.0	-304.0
chrX	53217277	53217795	53217202	53217868	JUNC00002688	90	-	75	73	-304.0	-304.0	-304.0
chrX	53217966	53218275	53217891	53218349	JUNC00002689	90	-	75	74	-304.0	-304.0	-304.0
chrX	53218398	53220838	53218323	53220912	JUNC00002690	113	-	75	74	-304.0	-304.0	-304.0
chrX	53220916	53221687	53220844	53221749	JUNC00002692	13	-	72	62	-304.0	-304.0	-304.0
chrX	53220916	53223984	53220886	53224027	JUNC00002693	1	-	30	43	-304.0	-304.0	-304.0
chrX	53220916	53224739	53220843	53224813	JUNC00002691	82	-	73	74	-304.0	-304.0	-304.0
chrX	53221730	53224739	53221686	53224808	JUNC00002694	7	-	44	69	-304.0	-304.0	-304.0
chrX	53221793	53224739	53221718	53224810	JUNC00002695	13	-	75	71	-304.0	-304.0	-304.0
chrX	53251174	53254529	53251126	53254557	JUNC00002696	1	-	48	28	-304.0	-304.0	-304.0
chrX	53351966	53445199	53351929	53445238	JUNC00002697	1	-	37	39	-304.0	-304.0	-304.0
chrX	53360589	53388821	53360535	53388846	JUNC00002698	3	-	54	25	120.0	118.0	120.0
chrX	53361709	53380619	53361687	53380673	JUNC00002699	1	-	22	54	-304.0	-304.0	-304.0
chrX	53380182	53380619	53380141	53380652	JUNC00002701	1	-	41	33	-304.0	-304.0	-304.0
chrX	53380186	53380619	53380111	53380694	JUNC00002700	228	-	75	75	-304.0	-304.0	-304.0
chrX	53380730	53381017	53380655	53381090	JUNC00002702	295	-	75	73	-304.0	-304.0	-304.0
chrX	53380730	53382231	53380655	53382279	JUNC00002703	19	-	75	48	-304.0	-304.0	-304.0
chrX	53381087	53382231	53381013	53382306	JUNC00002704	258	-	74	75	-304.0	-304.0	-304.0
chrX	53382383	53382505	53382308	53382580	JUNC00002705	256	-	75	75	-304.0	-304.0	-304.0
chrX	53382660	53383096	53382586	53383171	JUNC00002706	321	-	74	75	-304.0	-304.0	-304.0
chrX	53383253	53394777	53383178	53394852	JUNC00002707	234	-	75	75	-304.0	-304.0	-304.0
chrX	53394888	53396226	53394813	53396301	JUNC00002708	258	-	75	75	-304.0	-304.0	-304.0
chrX	53396380	53396471	53396305	53396546	JUNC00002709	256	-	75	75	-304.0	-304.0	-304.0
chrX	53396617	53399588	53396543	53399663	JUNC00002710	257	-	74	75	-304.0	-304.0	-304.0
chrX	53396617	53405011	53396571	53405086	JUNC00002711	5	-	46	75	-304.0	-304.0	-304.0
chrX	53399730	53403565	53399655	53403640	JUNC00002712	214	-	75	75	-304.0	-304.0	-304.0
chrX	53403672	53403776	53403597	53403851	JUNC00002713	255	-	75	75	-304.0	-304.0	-304.0
chrX	53403893	53405011	53403818	53405086	JUNC00002714	240	-	75	75	-304.0	-304.0	-304.0
chrX	53404581	53406785	53404561	53406841	JUNC00002715	1	-	20	56	130.0	-304.0	130.0
chrX	53405149	53405244	53405075	53405319	JUNC00002716	214	-	74	75	-304.0	-304.0	-304.0
chrX	53405391	53405492	53405316	53405567	JUNC00002717	152	-	75	75	-304.0	-304.0	-304.0
chrX	53405672	53405770	53405597	53405844	JUNC00002718	216	-	75	74	-304.0	-304.0	-304.0
chrX	53405956	53409061	53405881	53409136	JUNC00002719	174	-	75	75	-304.0	-304.0	-304.0
chrX	53409269	53409420	53409194	53409495	JUNC00002720	242	-	75	75	-304.0	-304.0	-304.0
chrX	53409503	53411760	53409428	53411835	JUNC00002721	272	-	75	75	-304.0	-304.0	-304.0
chrX	53411901	53411994	53411830	53412069	JUNC00002722	321	-	71	75	-304.0	-304.0	-304.0
chrX	53412071	53412092	53412030	53412127	JUNC00002723	1	?	41	35	110.0	110.0	110.0
chrX	53412253	53412899	53412178	53412974	JUNC00002724	286	-	75	75	-304.0	-304.0	-304.0
chrX	53413138	53413231	53413065	53413306	JUNC00002725	181	-	73	75	-304.0	-304.0	-304.0
chrX	53413435	53414757	53413360	53414832	JUNC00002726	148	-	75	75	-304.0	-304.0	-304.0
chrX	53413435	53421894	53413391	53421926	JUNC00002728	1	-	44	32	-304.0	-304.0	-304.0
chrX	53413435	53422491	53413363	53422549	JUNC00002727	6	-	72	58	-304.0	-304.0	-304.0
chrX	53414870	53414980	53414795	53415055	JUNC00002729	176	-	75	75	-304.0	-304.0	-304.0
chrX	53415169	53421894	53415094	53421955	JUNC00002732	7	-	75	61	-304.0	-304.0	-304.0
chrX	53415169	53422013	53415094	53422037	JUNC00002730	2	-	75	24	-304.0	-304.0	-304.0
chrX	53415169	53422491	53415094	53422562	JUNC00002731	118	-	75	71	-304.0	-304.0	-304.0
chrX	53418248	53419746	53418231	53419805	JUNC00002733	1	-	17	59	-304.0	-304.0	-304.0
chrX	53422040	53422491	53421991	53422555	JUNC00002734	4	-	49	64	-304.0	-304.0	-304.0
chrX	53423004	53423313	53422946	53423331	JUNC00002735	1	+	58	18	-304.0	-304.0	-304.0
chrX	53423402	53426276	53423363	53426313	JUNC00002736	1	+	39	37	-304.0	-304.0	-304.0
chrX	53426393	53428002	53426337	53428067	JUNC00002737	2	+	56	65	-304.0	-304.0	-304.0
chrX	53430790	53430906	53430715	53430955	JUNC00002738	3	+	75	49	-304.0	-304.0	-304.0
chrX	53431594	53431797	53431519	53431872	JUNC00002739	539	-	75	75	-304.0	-304.0	-304.0
chrX	53431594	53431824	53431519	53431899	JUNC00002740	27	-	75	75	-304.0	-304.0	-304.0
chrX	53431594	53431973	53431519	53431995	JUNC00002741	3	-	75	22	-304.0	-304.0	-304.0
chrX	53431594	53431987	53431519	53432062	JUNC00002742	15	-	75	75	-304.0	-304.0	-304.0
chrX	53431906	53431987	53431831	53432062	JUNC00002743	458	-	75	75	-304.0	-304.0	-304.0
chrX	53431906	53431992	53431831	53432067	JUNC00002744	7	-	75	75	-304.0	-304.0	-304.0
chrX	53432116	53432246	53432041	53432321	JUNC00002745	576	-	75	75	-304.0	-304.0	-304.0
chrX	53432411	53433721	53432336	53433796	JUNC00002746	384	-	75	75	-304.0	-304.0	-304.0
chrX	53433124	53433721	53433078	53433751	JUNC00002747	1	-	46	30	-304.0	-304.0	-304.0
chrX	53433886	53434318	53433814	53434369	JUNC00002748	38	-	72	51	-304.0	-304.0	-304.0
chrX	53493986	53497897	53493947	53497934	JUNC00002749	1	-	39	37	-304.0	-304.0	-304.0
chrX	53533411	53533890	53533336	53533948	JUNC00002752	2	-	75	58	-304.0	-304.0	-304.0
chrX	53533411	53533994	53533336	53534032	JUNC00002751	7	-	75	38	-304.0	-304.0	-304.0
chrX	53533411	53534006	53533336	53534081	JUNC00002750	363	-	75	75	-304.0	-304.0	-304.0
chrX	53534197	53534515	53534126	53534590	JUNC00002753	417	-	71	75	-304.0	-304.0	-304.0
chrX	53534611	53535383	53534591	53535458	JUNC00002754	3	-	20	75	-304.0	-304.0	-304.0
chrX	53534697	53535383	53534623	53535458	JUNC00002755	267	-	74	75	-304.0	-304.0	-304.0
chrX	53535501	53536146	53535426	53536221	JUNC00002756	360	-	75	75	-304.0	-304.0	-304.0
chrX	53536252	53536379	53536177	53536454	JUNC00002757	300	-	75	75	-304.0	-304.0	-304.0
chrX	53536667	53537555	53536592	53537630	JUNC00002758	215	-	75	75	-304.0	-304.0	-304.0
chrX	53537696	53538336	53537622	53538411	JUNC00002759	415	-	74	75	-304.0	-304.0	-304.0
chrX	53538428	53538834	53538353	53538909	JUNC00002760	20	-	75	75	-304.0	-304.0	-304.0
chrX	53538454	53538834	53538379	53538909	JUNC00002761	524	-	75	75	-304.0	-304.0	-304.0
chrX	53538454	53539656	53538380	53539706	JUNC00002762	12	-	74	50	-304.0	-304.0	-304.0
chrX	53539080	53539656	53539005	53539731	JUNC00002763	275	-	75	75	-304.0	-304.0	-304.0
chrX	53539812	53542442	53539737	53542517	JUNC00002764	457	-	75	75	-304.0	-304.0	-304.0
chrX	53542539	53543840	53542464	53543913	JUNC00002766	326	-	75	73	-304.0	-304.0	-304.0
chrX	53542539	53543885	53542464	53543959	JUNC00002765	124	-	75	74	-304.0	-304.0	-304.0
chrX	53542539	53546435	53542464	53546479	JUNC00002767	8	-	75	44	-304.0	-304.0	-304.0
chrX	53543968	53544559	53543893	53544634	JUNC00002769	256	-	75	75	-304.0	-304.0	-304.0
chrX	53543968	53545028	53543893	53545102	JUNC00002770	5	-	75	74	-304.0	-304.0	-304.0
chrX	53543968	53546435	53543893	53546506	JUNC00002768	7	-	75	71	-304.0	-304.0	-304.0
chrX	53544762	53545028	53544687	53545103	JUNC00002771	241	-	75	75	-304.0	-304.0	-304.0
chrX	53545161	53546435	53545086	53546510	JUNC00002772	251	-	75	75	-304.0	-304.0	-304.0
chrX	53546592	53546703	53546517	53546778	JUNC00002773	274	-	75	75	-304.0	-304.0	-304.0
chrX	53546592	53547672	53546553	53547709	JUNC00002774	1	-	39	37	-304.0	-304.0	-304.0
chrX	53546808	53547672	53546757	53547727	JUNC00002776	3	-	51	55	-304.0	-304.0	-304.0
chrX	53546808	53548958	53546759	53549010	JUNC00002777	2	-	49	52	-304.0	-304.0	-304.0
chrX	53546825	53547672	53546750	53547747	JUNC00002775	324	-	75	75	-304.0	-304.0	-304.0
chrX	53548273	53548958	53548198	53549033	JUNC00002778	335	-	75	75	-304.0	-304.0	-304.0
chrX	53549505	53550665	53549430	53550740	JUNC00002779	273	-	75	75	-304.0	-304.0	-304.0
chrX	53550768	53550888	53550715	53550932	JUNC00002781	2	-	53	44	-304.0	-304.0	-304.0
chrX	53550768	53550900	53550693	53550975	JUNC00002780	238	-	75	75	-304.0	-304.0	-304.0
chrX	53551189	53551265	53551114	53551340	JUNC00002783	369	-	75	75	-304.0	-304.0	-304.0
chrX	53551189	53551313	53551114	53551388	JUNC00002782	38	-	75	75	-304.0	-304.0	-304.0
chrX	53551480	53552310	53551405	53552385	JUNC00002784	215	-	75	75	-304.0	-304.0	-304.0
chrX	53552441	53552637	53552366	53552711	JUNC00002785	254	-	75	74	-304.0	-304.0	-304.0
chrX	53552893	53554632	53552820	53554706	JUNC00002786	223	-	73	74	-304.0	-304.0	-304.0
chrX	53554920	53557381	53554845	53557430	JUNC00002787	365	-	75	49	-304.0	-304.0	-304.0
chrX	53557427	53558654	53557381	53558729	JUNC00002788	293	-	46	75	-304.0	-304.0	-304.0
chrX	53557427	53558970	53557400	53559045	JUNC00002789	3	-	27	75	-304.0	-304.0	-304.0
chrX	53558809	53558970	53558735	53559045	JUNC00002790	274	-	74	75	-304.0	-304.0	-304.0
chrX	53559060	53559353	53558986	53559427	JUNC00002791	180	-	74	74	-304.0	-304.0	-304.0
chrX	53559532	53560187	53559457	53560262	JUNC00002792	211	-	75	75	-304.0	-304.0	-304.0
chrX	53560413	53561755	53560373	53561830	JUNC00002795	4	-	40	75	-304.0	-304.0	-304.0
chrX	53560416	53561755	53560341	53561830	JUNC00002793	286	-	75	75	-304.0	-304.0	-304.0
chrX	53560416	53563745	53560359	53563815	JUNC00002794	8	-	57	70	-304.0	-304.0	-304.0
chrX	53561924	53562110	53561849	53562185	JUNC00002796	395	-	75	75	-304.0	-304.0	-304.0
chrX	53562193	53562830	53562119	53562905	JUNC00002797	10	-	74	75	-304.0	-304.0	-304.0
chrX	53562244	53562830	53562169	53562905	JUNC00002798	370	-	75	75	-304.0	-304.0	-304.0
chrX	53562244	53563745	53562169	53563809	JUNC00002799	39	-	75	64	-304.0	-304.0	-304.0
chrX	53562929	53563745	53562854	53563820	JUNC00002800	282	-	75	75	-304.0	-304.0	-304.0
chrX	53563821	53564573	53563746	53564648	JUNC00002801	289	-	75	75	-304.0	-304.0	-304.0
chrX	53564722	53565066	53564647	53565141	JUNC00002802	227	-	75	75	-304.0	-304.0	-304.0
chrX	53565239	53568691	53565164	53568766	JUNC00002803	289	-	75	75	-304.0	-304.0	-304.0
chrX	53568874	53569615	53568801	53569689	JUNC00002804	145	-	73	74	-304.0	-304.0	-304.0
chrX	53569827	53573749	53569752	53573823	JUNC00002805	211	-	75	74	-304.0	-304.0	-304.0
chrX	53573964	53575154	53573892	53575221	JUNC00002806	127	-	72	67	-304.0	-304.0	-304.0
chrX	53575221	53575642	53575154	53575717	JUNC00002807	155	-	67	75	-304.0	-304.0	-304.0
chrX	53575785	53576899	53575710	53576968	JUNC00002808	43	-	75	69	-304.0	-304.0	-304.0
chrX	53575788	53576899	53575714	53576970	JUNC00002809	125	-	74	71	-304.0	-304.0	-304.0
chrX	53577067	53580830	53576992	53580903	JUNC00002810	135	-	75	73	-304.0	-304.0	-304.0
chrX	53581026	53583557	53580951	53583632	JUNC00002811	182	-	75	75	-304.0	-304.0	-304.0
chrX	53583916	53584185	53583845	53584258	JUNC00002812	236	-	71	73	-304.0	-304.0	-304.0
chrX	53584345	53585011	53584270	53585082	JUNC00002813	164	-	75	71	-304.0	-304.0	-304.0
chrX	53585171	53586489	53585096	53586515	JUNC00002814	2	-	75	26	-304.0	-304.0	-304.0
chrX	53585188	53586477	53585169	53586534	JUNC00002816	1	-	19	57	-304.0	-304.0	-304.0
chrX	53585188	53586489	53585113	53586563	JUNC00002815	189	-	75	74	-304.0	-304.0	-304.0
chrX	53586571	53586781	53586496	53586856	JUNC00002817	199	-	75	75	-304.0	-304.0	-304.0
chrX	53586909	53587046	53586873	53587086	JUNC00002819	1	-	36	40	-304.0	-304.0	-304.0
chrX	53586909	53588381	53586835	53588456	JUNC00002818	181	-	74	75	-304.0	-304.0	-304.0
chrX	53588534	53589546	53588459	53589621	JUNC00002820	164	-	75	75	-304.0	-304.0	-304.0
chrX	53589816	53590403	53589741	53590478	JUNC00002821	237	-	75	75	-304.0	-304.0	-304.0
chrX	53590499	53590999	53590424	53591074	JUNC00002822	181	-	75	75	-304.0	-304.0	-304.0
chrX	53590499	53592397	53590472	53592446	JUNC00002823	1	-	27	49	-304.0	-304.0	-304.0
chrX	53591122	53592397	53591048	53592472	JUNC00002824	255	-	74	75	-304.0	-304.0	-304.0
chrX	53592628	53593363	53592553	53593437	JUNC00002825	202	-	75	74	-304.0	-304.0	-304.0
chrX	53593601	53594498	53593527	53594573	JUNC00002826	220	-	74	75	-304.0	-304.0	-304.0
chrX	53594621	53595186	53594546	53595261	JUNC00002827	210	-	75	75	-304.0	-304.0	-304.0
chrX	53595403	53600117	53595328	53600192	JUNC00002828	196	-	75	75	-304.0	-304.0	-304.0
chrX	53600309	53602563	53600236	53602637	JUNC00002830	213	-	73	74	-304.0	-304.0	-304.0
chrX	53600309	53602590	53600236	53602644	JUNC00002829	11	-	73	54	-304.0	-304.0	-304.0
chrX	53602658	53603367	53602583	53603442	JUNC00002831	210	-	75	75	-304.0	-304.0	-304.0
chrX	53603501	53604588	53603426	53604662	JUNC00002832	154	-	75	74	-304.0	-304.0	-304.0
chrX	53604631	53604667	53604588	53604691	JUNC00002833	1	-	43	24	-304.0	-304.0	-304.0
chrX	53604834	53607522	53604759	53607597	JUNC00002834	179	-	75	75	-304.0	-304.0	-304.0
chrX	53607699	53608851	53607625	53608909	JUNC00002835	172	-	74	58	-304.0	-304.0	-304.0
chrX	53608909	53614533	53608851	53614608	JUNC00002836	161	-	58	75	-304.0	-304.0	-304.0
chrX	53614745	53615743	53614670	53615818	JUNC00002837	142	-	75	75	-304.0	-304.0	-304.0
chrX	53615835	53616969	53615763	53617043	JUNC00002838	133	-	72	74	-304.0	-304.0	-304.0
chrX	53617147	53617339	53617072	53617412	JUNC00002839	212	-	75	73	-304.0	-304.0	-304.0
chrX	53617446	53624594	53617372	53624669	JUNC00002840	169	-	74	75	-304.0	-304.0	-304.0
chrX	53624675	53625156	53624600	53625231	JUNC00002841	162	-	75	75	-304.0	-304.0	-304.0
chrX	53625258	53625785	53625183	53625832	JUNC00002843	26	-	75	47	-304.0	-304.0	-304.0
chrX	53625258	53627409	53625183	53627484	JUNC00002842	53	-	75	75	-304.0	-304.0	-304.0
chrX	53626034	53627409	53625959	53627484	JUNC00002844	93	-	75	75	-304.0	-304.0	-304.0
chrX	53627515	53627738	53627440	53627813	JUNC00002845	137	-	75	75	-304.0	-304.0	-304.0
chrX	53627879	53628492	53627808	53628566	JUNC00002846	138	-	71	74	-304.0	-304.0	-304.0
chrX	53628620	53628751	53628545	53628825	JUNC00002847	146	-	75	74	-304.0	-304.0	-304.0
chrX	53628902	53629515	53628827	53629590	JUNC00002848	101	-	75	75	-304.0	-304.0	-304.0
chrX	53629616	53630934	53629541	53631009	JUNC00002849	96	-	75	75	-304.0	-304.0	-304.0
chrX	53629637	53630934	53629600	53631009	JUNC00002850	4	-	37	75	-304.0	-304.0	-304.0
chrX	53631034	53631413	53630960	53631484	JUNC00002851	127	-	74	71	-304.0	-304.0	-304.0
chrX	53631482	53631566	53631413	53631615	JUNC00002852	128	-	69	49	-304.0	-304.0	-304.0
chrX	53631614	53632486	53631566	53632560	JUNC00002853	147	-	48	74	-304.0	-304.0	-304.0
chrX	53632564	53634235	53632489	53634300	JUNC00002854	135	-	75	65	-304.0	-304.0	-304.0
chrX	53634298	53645310	53634235	53645383	JUNC00002855	145	-	63	73	-304.0	-304.0	-304.0
chrX	53637354	53645310	53637335	53645367	JUNC00002856	1	-	19	57	-304.0	-304.0	-304.0
chrX	53645463	53647367	53645388	53647442	JUNC00002857	129	-	75	75	-304.0	-304.0	-304.0
chrX	53645463	53654062	53645414	53654089	JUNC00002858	1	-	49	27	-304.0	-304.0	-304.0
chrX	53647574	53648211	53647499	53648286	JUNC00002859	141	-	75	75	-304.0	-304.0	-304.0
chrX	53648310	53648572	53648248	53648634	JUNC00002861	3	-	62	62	-304.0	-304.0	-304.0
chrX	53648310	53654062	53648238	53654133	JUNC00002860	114	-	72	71	-304.0	-304.0	-304.0
chrX	53654131	53672507	53654062	53672561	JUNC00002864	5	-	69	54	-304.0	-304.0	-304.0
chrX	53654131	53680048	53654062	53680122	JUNC00002863	140	-	69	74	-304.0	-304.0	-304.0
chrX	53654131	53686269	53654062	53686287	JUNC00002862	4	-	69	18	-304.0	-304.0	-304.0
chrX	53672586	53680048	53672548	53680090	JUNC00002865	2	-	38	42	-304.0	-304.0	-304.0
chrX	53680186	53683369	53680114	53683421	JUNC00002870	7	-	72	52	-304.0	-304.0	-304.0
chrX	53680186	53683873	53680111	53683942	JUNC00002866	44	-	75	69	-304.0	-304.0	-304.0
chrX	53680186	53684179	53680111	53684248	JUNC00002867	7	-	75	69	-304.0	-304.0	-304.0
chrX	53680186	53686165	53680111	53686231	JUNC00002868	23	-	75	66	-304.0	-304.0	-304.0
chrX	53680186	53686269	53680111	53686314	JUNC00002869	17	-	75	45	-304.0	-304.0	-304.0
chrX	53680186	53716322	53680131	53716350	JUNC00002871	2	-	55	28	-304.0	-304.0	-304.0
chrX	53683410	53683688	53683386	53683740	JUNC00002872	1	-	24	52	-304.0	-304.0	-304.0
chrX	53684319	53686165	53684251	53686189	JUNC00002873	3	-	68	24	-304.0	-304.0	-304.0
chrX	53699781	53713967	53699761	53714023	JUNC00002874	1	-	20	56	-304.0	-304.0	-304.0
chrX	53708865	53711436	53708836	53711483	JUNC00002875	1	+	29	47	-304.0	-304.0	-304.0
chrX	53714791	53715701	53714740	53715726	JUNC00002876	1	-	51	25	-304.0	-304.0	-304.0
chrX	53715883	53716322	53715823	53716338	JUNC00002877	1	-	60	16	-304.0	-304.0	-304.0
chrX	53730864	53836674	53730819	53836705	JUNC00002878	1	-	45	31	-304.0	-304.0	-304.0
chrX	53816687	53826830	53816662	53826881	JUNC00002879	1	-	25	51	-304.0	-304.0	-304.0
chrX	53885945	53953499	53885917	53953547	JUNC00002880	1	+	28	48	-304.0	-304.0	-304.0
chrX	53907298	53929044	53907269	53929095	JUNC00002881	2	+	29	51	-304.0	-304.0	-304.0
chrX	53928950	53947154	53928920	53947200	JUNC00002882	1	+	30	46	-304.0	-304.0	-304.0
chrX	53938059	53939161	53937987	53939234	JUNC00002883	17	-	72	73	-304.0	-304.0	-304.0
chrX	53938211	53939161	53938188	53939213	JUNC00002884	1	-	23	52	-304.0	-304.0	-304.0
chrX	53939246	53940179	53939171	53940250	JUNC00002885	63	-	75	71	-304.0	-304.0	-304.0
chrX	53940516	53944133	53940442	53944207	JUNC00002886	51	-	74	74	-304.0	-304.0	-304.0
chrX	53943402	53944133	53943345	53944152	JUNC00002887	1	-	57	19	-304.0	-304.0	-304.0
chrX	53944243	53962843	53944170	53962915	JUNC00002888	76	-	73	72	-304.0	-304.0	-304.0
chrX	53949581	54001096	53949549	54001140	JUNC00002889	1	+	32	44	-304.0	-304.0	-304.0
chrX	53962939	53984913	53962864	53984986	JUNC00002890	57	-	75	73	-304.0	-304.0	-304.0
chrX	53962939	53985815	53962924	53985876	JUNC00002891	1	-	15	61	-304.0	-304.0	-304.0
chrX	53985227	53985815	53985154	53985885	JUNC00002892	52	-	73	70	-304.0	-304.0	-304.0
chrX	53985949	53987077	53985874	53987152	JUNC00002893	90	-	75	75	-304.0	-304.0	-304.0
chrX	53987163	53987765	53987088	53987835	JUNC00002894	72	-	75	70	-304.0	-304.0	-304.0
chrX	53987944	53992735	53987870	53992810	JUNC00002895	77	-	74	75	-304.0	-304.0	-304.0
chrX	53992839	53993600	53992765	53993675	JUNC00002897	62	-	74	75	-304.0	-304.0	-304.0
chrX	53992839	53995692	53992764	53995757	JUNC00002896	16	-	75	65	-304.0	-304.0	-304.0
chrX	53993903	53995692	53993829	53995767	JUNC00002898	36	-	74	75	-304.0	-304.0	-304.0
chrX	53995782	53999869	53995708	53999944	JUNC00002899	54	-	74	75	-304.0	-304.0	-304.0
chrX	53999961	54002154	53999889	54002225	JUNC00002900	64	-	72	71	-304.0	-304.0	-304.0
chrX	54002261	54002594	54002187	54002668	JUNC00002901	61	-	74	74	-304.0	-304.0	-304.0
chrX	54002682	54011121	54002607	54011195	JUNC00002902	58	-	75	74	-304.0	-304.0	-304.0
chrX	54011284	54014376	54011209	54014445	JUNC00002903	70	-	75	69	-304.0	-304.0	-304.0
chrX	54014563	54016594	54014491	54016668	JUNC00002904	36	-	72	74	-304.0	-304.0	-304.0
chrX	54016736	54017660	54016670	54017730	JUNC00002905	28	-	66	70	-304.0	-304.0	-304.0
chrX	54017821	54022258	54017746	54022333	JUNC00002906	49	-	75	75	-304.0	-304.0	-304.0
chrX	54022367	54022757	54022303	54022831	JUNC00002907	62	-	64	74	-304.0	-304.0	-304.0
chrX	54022843	54042630	54022768	54042704	JUNC00002908	72	-	75	74	-304.0	-304.0	-304.0
chrX	54033858	54056923	54033823	54056964	JUNC00002909	1	+	35	41	-304.0	-304.0	-304.0
chrX	54040072	54042630	54040026	54042659	JUNC00002910	1	-	46	29	-304.0	-304.0	-304.0
chrX	54042820	54043761	54042754	54043833	JUNC00002911	9	-	66	72	-304.0	-304.0	-304.0
chrX	54042820	54043811	54042776	54043864	JUNC00002912	2	-	44	53	-304.0	-304.0	-304.0
chrX	54073287	54080231	54073252	54080283	JUNC00002913	2	-	35	52	-304.0	-304.0	-304.0
chrX	54080289	54081321	54080231	54081396	JUNC00002914	6	-	58	75	-304.0	-304.0	-304.0
chrX	54081460	54085714	54081392	54085766	JUNC00002915	4	-	68	52	-304.0	-304.0	-304.0
chrX	54085916	54087754	54085864	54087806	JUNC00002916	4	-	52	52	-304.0	-304.0	-304.0
chrX	54091426	54116544	54091355	54116612	JUNC00002917	5	-	71	68	-304.0	-304.0	-304.0
chrX	54108717	54147102	54108670	54147131	JUNC00002919	1	+	47	29	-304.0	116.0	116.0
chrX	54108717	54152982	54108670	54153011	JUNC00002918	1	+	47	29	-304.0	124.0	124.0
chrX	54115866	54118005	54115837	54118050	JUNC00002920	1	-	29	45	114.0	112.0	114.0
chrX	54132863	54133772	54132788	54133832	JUNC00002921	3	-	75	60	-304.0	-304.0	-304.0
chrX	54134046	54134830	54133989	54134905	JUNC00002922	3	-	57	75	-304.0	-304.0	-304.0
chrX	54135111	54135527	54135060	54135566	JUNC00002923	2	-	51	39	-304.0	-304.0	-304.0
chrX	54135604	54136490	54135567	54136529	JUNC00002924	1	-	37	39	-304.0	-304.0	-304.0
chrX	54136590	54151244	54136570	54151300	JUNC00002925	1	-	20	56	-304.0	-304.0	-304.0
chrX	54137095	54207656	54137041	54207679	JUNC00002926	3	+	54	23	124.0	108.0	124.0
chrX	54151373	54157688	54151331	54157746	JUNC00002927	2	-	42	58	-304.0	-304.0	-304.0
chrX	54157771	54159369	54157700	54159401	JUNC00002928	3	-	71	32	-304.0	-304.0	-304.0
chrX	54159616	54182499	54159572	54182531	JUNC00002929	1	-	44	32	-304.0	-304.0	-304.0
chrX	54174142	54182499	54174077	54182573	JUNC00002930	3	-	65	74	-304.0	-304.0	-304.0
chrX	54174146	54182499	54174077	54182538	JUNC00002931	4	-	69	39	-304.0	-304.0	-304.0
chrX	54198653	54201990	54198625	54202038	JUNC00002932	1	-	28	48	-304.0	-304.0	-304.0
chrX	54203733	54218670	54203714	54218722	JUNC00002933	1	+	19	52	-304.0	-304.0	-304.0
chrX	54251450	54251531	54251399	54251556	JUNC00002934	1	-	51	25	-304.0	-304.0	-304.0
chrX	54251687	54253958	54251662	54254009	JUNC00002935	1	-	25	51	-304.0	-304.0	-304.0
chrX	54259338	54292887	54259273	54292916	JUNC00002936	3	-	65	29	-304.0	-304.0	-304.0
chrX	54291187	54301117	54291157	54301163	JUNC00002937	1	-	30	46	-304.0	-304.0	-304.0
chrX	54293037	54293133	54293004	54293176	JUNC00002938	1	-	33	43	-304.0	-304.0	-304.0
chrX	54308079	54309094	54308022	54309113	JUNC00002939	1	-	57	19	-304.0	-304.0	-304.0
chrX	54391982	54397724	54391948	54397765	JUNC00002940	1	+	34	41	122.0	122.0	122.0
chrX	54413166	54424643	54413126	54424679	JUNC00002941	1	+	40	36	118.0	-304.0	118.0
chrX	54429065	54433943	54429045	54433999	JUNC00002942	1	-	20	56	-304.0	-304.0	-304.0
chrX	54432647	54433943	54432627	54433999	JUNC00002943	1	-	20	56	120.0	-304.0	120.0
chrX	54432964	54438844	54432941	54438890	JUNC00002944	1	-	23	46	-304.0	128.0	128.0
chrX	54440502	54440689	54440427	54440762	JUNC00002945	88	+	75	73	-304.0	-304.0	-304.0
chrX	54440780	54443399	54440705	54443474	JUNC00002946	172	+	75	75	-304.0	-304.0	-304.0
chrX	54443491	54444007	54443416	54444081	JUNC00002947	209	+	75	74	-304.0	-304.0	-304.0
chrX	54443491	54444016	54443444	54444091	JUNC00002948	14	+	47	75	-304.0	-304.0	-304.0
chrX	54444184	54444415	54444109	54444490	JUNC00002949	192	+	75	75	-304.0	-304.0	-304.0
chrX	54446002	54446080	54445974	54446128	JUNC00002950	1	?	28	48	-304.0	-304.0	-304.0
chrX	54487736	54498579	54487697	54498616	JUNC00002951	1	+	39	37	-304.0	-304.0	-304.0
chrX	54504770	54564319	54504743	54564365	JUNC00002953	1	-	27	46	-304.0	-304.0	-304.0
chrX	54504782	54568696	54504721	54568711	JUNC00002952	1	+	61	15	108.0	-304.0	108.0
chrX	54510957	54562667	54510941	54562726	JUNC00002954	2	-	16	59	-304.0	-304.0	-304.0
chrX	54525549	54564821	54525527	54564875	JUNC00002955	1	-	22	54	-304.0	110.0	110.0
chrX	54530302	54532519	54530236	54532585	JUNC00002956	18	+	66	66	-304.0	-304.0	-304.0
chrX	54530419	54532519	54530346	54532585	JUNC00002958	51	+	73	66	-304.0	-304.0	-304.0
chrX	54530419	54532523	54530382	54532585	JUNC00002959	2	+	37	62	-304.0	-304.0	-304.0
chrX	54532585	54539039	54532518	54539101	JUNC00002957	57	+	67	62	-304.0	-304.0	-304.0
chrX	54537164	54539039	54537092	54539065	JUNC00002961	2	+	72	26	-304.0	-304.0	-304.0
chrX	54537302	54539039	54537259	54539072	JUNC00002962	1	+	43	33	-304.0	-304.0	-304.0
chrX	54539101	54540134	54539039	54540209	JUNC00002960	81	+	62	75	-304.0	-304.0	-304.0
chrX	54540242	54541272	54540167	54541347	JUNC00002963	64	+	75	75	-304.0	-304.0	-304.0
chrX	54541389	54542954	54541314	54543029	JUNC00002964	94	+	75	75	-304.0	-304.0	-304.0
chrX	54543038	54543206	54542965	54543277	JUNC00002965	79	+	73	71	-304.0	-304.0	-304.0
chrX	54543342	54544222	54543267	54544296	JUNC00002966	81	+	75	74	-304.0	-304.0	-304.0
chrX	54544326	54548228	54544252	54548303	JUNC00002967	76	+	74	75	-304.0	-304.0	-304.0
chrX	54548373	54550962	54548306	54551034	JUNC00002968	42	+	67	72	-304.0	-304.0	-304.0
chrX	54551050	54551567	54550975	54551640	JUNC00002969	56	+	75	73	-304.0	-304.0	-304.0
chrX	54551742	54551831	54551668	54551906	JUNC00002970	55	+	74	75	-304.0	-304.0	-304.0
chrX	54551974	54552291	54551899	54552366	JUNC00002971	65	+	75	75	-304.0	-304.0	-304.0
chrX	54552428	54554299	54552371	54554317	JUNC00002973	1	+	57	18	-304.0	-304.0	-304.0
chrX	54552428	54554564	54552353	54554638	JUNC00002972	85	+	75	74	-304.0	-304.0	-304.0
chrX	54554692	54558435	54554617	54558507	JUNC00002974	75	+	75	72	-304.0	-304.0	-304.0
chrX	54558655	54560519	54558581	54560594	JUNC00002975	61	+	74	75	-304.0	-304.0	-304.0
chrX	54560647	54620844	54560609	54620882	JUNC00002976	1	+	38	38	-304.0	-304.0	-304.0
chrX	54560962	54560994	54560946	54561054	JUNC00002977	1	-	16	60	-304.0	-304.0	-304.0
chrX	54657247	54771403	54657202	54771434	JUNC00002978	1	+	45	31	-304.0	-304.0	-304.0
chrX	54807802	54809302	54807732	54809377	JUNC00002979	27	+	70	75	-304.0	-304.0	-304.0
chrX	54808433	54809302	54808361	54809377	JUNC00002981	39	+	72	75	-304.0	-304.0	-304.0
chrX	54809223	54809302	54809150	54809377	JUNC00002982	65	+	73	75	-304.0	-304.0	-304.0
chrX	54809376	54809721	54809301	54809795	JUNC00002980	218	+	75	74	-304.0	-304.0	-304.0
chrX	54810213	54810820	54810138	54810891	JUNC00002983	210	+	75	71	-304.0	-304.0	-304.0
chrX	54811129	54811249	54811055	54811313	JUNC00002984	118	+	74	64	-304.0	-304.0	-304.0
chrX	54811313	54811573	54811248	54811648	JUNC00002985	140	+	65	75	-304.0	-304.0	-304.0
chrX	54811653	54812156	54811579	54812230	JUNC00002986	154	+	74	74	-304.0	-304.0	-304.0
chrX	54812251	54812944	54812176	54813019	JUNC00002987	163	+	75	75	-304.0	-304.0	-304.0
chrX	54813024	54813117	54812951	54813182	JUNC00002988	127	+	73	65	-304.0	-304.0	-304.0
chrX	54813160	54813487	54813116	54813552	JUNC00002989	163	+	44	65	-304.0	-304.0	-304.0
chrX	54813550	54814660	54813485	54814735	JUNC00002990	168	+	65	75	-304.0	-304.0	-304.0
chrX	54814775	54815247	54814701	54815318	JUNC00002991	137	+	74	71	-304.0	-304.0	-304.0
chrX	54815545	54815575	54815519	54815625	JUNC00002992	1	?	26	50	92.0	92.0	92.0
chrX	54815690	54815880	54815618	54815955	JUNC00002993	43	+	72	75	-304.0	-304.0	-304.0
chrX	54920878	54922217	54920826	54922283	JUNC00002994	5	+	52	66	-304.0	-304.0	-304.0
chrX	54922291	54922577	54922220	54922652	JUNC00002995	10	+	71	75	-304.0	-304.0	-304.0
chrX	54922291	54922623	54922241	54922649	JUNC00002996	1	+	50	26	-304.0	-304.0	-304.0
chrX	54922291	54924450	54922290	54924525	JUNC00002997	1	+	1	75	-304.0	-304.0	-304.0
chrX	54923768	54924450	54923695	54924525	JUNC00002998	12	+	73	75	-304.0	-304.0	-304.0
chrX	54924555	54924669	54924481	54924733	JUNC00002999	11	+	74	64	-304.0	-304.0	-304.0
chrX	54924733	54924988	54924669	54925063	JUNC00003000	11	+	64	75	-304.0	-304.0	-304.0
chrX	54925068	54925591	54924997	54925660	JUNC00003001	13	+	71	69	-304.0	-304.0	-304.0
chrX	54925683	54926409	54925623	54926477	JUNC00003002	10	+	60	68	-304.0	-304.0	-304.0
chrX	54926489	54926582	54926427	54926644	JUNC00003003	8	+	62	62	-304.0	-304.0	-304.0
chrX	54926625	54927042	54926582	54927105	JUNC00003004	9	+	43	63	-304.0	-304.0	-304.0
chrX	54926705	54927042	54926686	54927099	JUNC00003006	1	+	19	57	-304.0	-304.0	-304.0
chrX	54927105	54927666	54927042	54927735	JUNC00003005	12	+	63	69	-304.0	-304.0	-304.0
chrX	54927781	54928602	54927718	54928674	JUNC00003007	23	+	63	72	-304.0	-304.0	-304.0
chrX	54928710	54930740	54928666	54930803	JUNC00003008	2	+	44	63	-304.0	-304.0	-304.0
chrX	54931031	54931203	54930957	54931257	JUNC00003009	10	+	74	54	-304.0	-304.0	-304.0
chrX	54933885	54934946	54933868	54935005	JUNC00003010	1	-	17	59	-304.0	-304.0	-304.0
chrX	54935009	54937594	54934966	54937627	JUNC00003011	1	-	43	33	-304.0	-304.0	-304.0
chrX	54945543	54949074	54945528	54949135	JUNC00003012	1	-	15	61	-304.0	-304.0	-304.0
chrX	54958362	54958850	54958294	54958912	JUNC00003013	2	-	68	62	-304.0	-304.0	-304.0
chrX	55000579	55001545	55000506	55001619	JUNC00003014	150	+	73	74	-304.0	-304.0	-304.0
chrX	55001629	55002250	55001554	55002325	JUNC00003015	98	+	75	75	-304.0	-304.0	-304.0
chrX	55001629	55002961	55001562	55003027	JUNC00003016	12	+	67	66	-304.0	-304.0	-304.0
chrX	55002431	55002961	55002356	55003035	JUNC00003017	113	+	75	74	-304.0	-304.0	-304.0
chrX	55003108	55003798	55003033	55003869	JUNC00003018	148	+	75	71	-304.0	-304.0	-304.0
chrX	55003868	55006517	55003795	55006591	JUNC00003019	140	+	73	74	-304.0	-304.0	-304.0
chrX	55003868	55006871	55003843	55006922	JUNC00003020	1	+	25	51	-304.0	-304.0	-304.0
chrX	55076125	55076568	55076085	55076604	JUNC00003021	1	+	40	36	-304.0	-304.0	-304.0
chrX	55143875	55146180	55143872	55146253	JUNC00003022	1	-	3	73	-304.0	-304.0	-304.0
chrX	55146311	55159121	55146236	55159183	JUNC00003023	5	-	75	62	-304.0	-304.0	-304.0
chrX	55146311	55159128	55146236	55159202	JUNC00003024	32	-	75	74	-304.0	-304.0	-304.0
chrX	55159228	55160829	55159201	55160878	JUNC00003027	1	-	27	49	-304.0	-304.0	-304.0
chrX	55159228	55160974	55159183	55161038	JUNC00003026	9	-	45	64	-304.0	-304.0	-304.0
chrX	55159228	55161136	55159154	55161199	JUNC00003025	27	-	74	63	-304.0	-304.0	-304.0
chrX	55488988	55489168	55488950	55489229	JUNC00003028	3	-	38	61	-304.0	-304.0	-304.0
chrX	55489365	55489775	55489339	55489825	JUNC00003029	1	-	26	50	-304.0	-304.0	-304.0
chrX	55718419	55719313	55718348	55719349	JUNC00003030	30	+	71	36	-304.0	-304.0	-304.0
chrX	55719347	55722185	55719312	55722259	JUNC00003031	29	+	35	74	-304.0	-304.0	-304.0
chrX	55722285	55727306	55722252	55727378	JUNC00003033	4	+	33	72	-304.0	-304.0	-304.0
chrX	55722285	55729293	55722213	55729360	JUNC00003032	22	+	72	67	-304.0	-304.0	-304.0
chrX	55727390	55729293	55727346	55729354	JUNC00003035	2	+	44	61	-304.0	-304.0	-304.0
chrX	55729360	55731363	55729293	55731437	JUNC00003034	29	+	67	74	-304.0	-304.0	-304.0
chrX	55731586	55751100	55731526	55751167	JUNC00003036	20	+	60	67	-304.0	-304.0	-304.0
chrX	55751196	55752240	55751158	55752315	JUNC00003038	3	+	38	75	-304.0	-304.0	-304.0
chrX	55751196	55752245	55751131	55752314	JUNC00003037	3	+	65	69	-304.0	-304.0	-304.0
chrX	55751196	55753391	55751162	55753453	JUNC00003039	4	+	34	62	-304.0	-304.0	-304.0
chrX	55752353	55753391	55752278	55753431	JUNC00003040	2	+	75	40	-304.0	-304.0	-304.0
chrX	55753514	55754835	55753471	55754868	JUNC00003042	1	+	43	33	-304.0	-304.0	-304.0
chrX	55753514	55755067	55753492	55755138	JUNC00003045	4	+	22	71	-304.0	-304.0	-304.0
chrX	55753514	55755840	55753450	55755909	JUNC00003041	13	+	64	69	-304.0	-304.0	-304.0
chrX	55753514	55755858	55753491	55755896	JUNC00003044	1	+	23	38	-304.0	-304.0	-304.0
chrX	55753514	55757215	55753474	55757290	JUNC00003043	2	+	40	75	-304.0	-304.0	-304.0
chrX	55755206	55755840	55755160	55755902	JUNC00003046	3	+	46	62	-304.0	-304.0	-304.0
chrX	55755932	55757215	55755865	55757290	JUNC00003047	29	+	67	75	-304.0	-304.0	-304.0
chrX	55757331	55758245	55757256	55758316	JUNC00003048	28	+	75	71	-304.0	-304.0	-304.0
chrX	55908800	55962342	55908748	55962366	JUNC00003049	1	+	52	24	-304.0	-304.0	-304.0
chrX	55908800	56014844	55908766	56014917	JUNC00003050	2	+	34	73	-304.0	-304.0	-304.0
chrX	55944477	56002824	55944427	56002850	JUNC00003051	1	+	50	26	-304.0	-304.0	-304.0
chrX	55962574	56204437	55962541	56204480	JUNC00003052	1	+	33	43	-304.0	-304.0	-304.0
chrX	55986224	55989687	55986194	55989733	JUNC00003054	2	+	30	46	-304.0	-304.0	-304.0
chrX	55986224	56002824	55986186	56002870	JUNC00003053	2	+	38	46	-304.0	-304.0	-304.0
chrX	55986224	56014844	55986195	56014891	JUNC00003055	1	+	29	47	-304.0	-304.0	-304.0
chrX	56014961	56204972	56014933	56205020	JUNC00003056	1	+	28	48	-304.0	-304.0	-304.0
chrX	56204514	56204972	56204461	56205002	JUNC00003057	2	+	53	30	-304.0	-304.0	-304.0
chrX	56232488	56233157	56232434	56233196	JUNC00003058	2	+	54	39	-304.0	-304.0	-304.0
chrX	56232805	56233157	56232754	56233198	JUNC00003059	2	+	51	41	-304.0	-304.0	-304.0
chrX	56233341	56250230	56233268	56250303	JUNC00003060	13	+	73	73	-304.0	-304.0	-304.0
chrX	56233341	56265179	56233286	56265254	JUNC00003061	3	+	55	75	-304.0	-304.0	-304.0
chrX	56250304	56265179	56250230	56265254	JUNC00003062	16	+	74	75	-304.0	-304.0	-304.0
chrX	56265744	56269377	56265669	56269452	JUNC00003063	15	+	75	75	-304.0	-304.0	-304.0
chrX	56269489	56270181	56269419	56270252	JUNC00003064	31	+	70	71	-304.0	-304.0	-304.0
chrX	56270321	56284312	56270248	56284384	JUNC00003065	14	+	73	72	-304.0	-304.0	-304.0
chrX	56314725	56315643	56314704	56315698	JUNC00003066	1	-	21	55	-304.0	-304.0	-304.0
chrX	56729589	56732062	56729514	56732066	JUNC00003067	49	+	75	4	-304.0	-304.0	-304.0
chrX	56729589	56798709	56729514	56798747	JUNC00003068	2	+	75	38	-304.0	-304.0	-304.0
chrX	56729589	56817319	56729519	56817394	JUNC00003069	166	+	70	75	-304.0	-304.0	-304.0
chrX	56732199	56817319	56732197	56817394	JUNC00003070	2	+	2	75	-304.0	-304.0	-304.0
chrX	56974898	56977072	56974866	56977116	JUNC00003071	1	-	32	44	-304.0	-304.0	-304.0
chrX	56977196	56978579	56977151	56978644	JUNC00003072	3	-	45	65	-304.0	-304.0	-304.0
chrX	56978660	56984265	56978591	56984305	JUNC00003073	9	-	69	40	-304.0	-304.0	-304.0
chrX	56984478	56994722	56984421	56994793	JUNC00003074	8	-	57	71	-304.0	-304.0	-304.0
chrX	56993888	56994722	56993841	56994782	JUNC00003075	2	-	47	60	-304.0	-304.0	-304.0
chrX	56994949	56995215	56994887	56995282	JUNC00003076	5	-	62	67	-304.0	-304.0	-304.0
chrX	56994949	56995241	56994898	56995303	JUNC00003077	5	-	51	62	-304.0	-304.0	-304.0
chrX	57107226	57109332	57107197	57109378	JUNC00003078	1	-	29	46	-304.0	-304.0	-304.0
chrX	57109403	57112748	57109347	57112768	JUNC00003079	1	-	56	20	-304.0	-304.0	-304.0
chrX	57112782	57114339	57112711	57114392	JUNC00003080	2	-	71	53	-304.0	-304.0	-304.0
chrX	57114467	57117834	57114452	57117895	JUNC00003082	1	-	15	61	-304.0	-304.0	-304.0
chrX	57114467	57118571	57114425	57118605	JUNC00003081	2	-	42	34	-304.0	-304.0	-304.0
chrX	57120101	57120404	57120068	57120447	JUNC00003083	1	-	33	43	-304.0	-304.0	-304.0
chrX	57120634	57121292	57120585	57121365	JUNC00003084	3	-	49	73	-304.0	-304.0	-304.0
chrX	57121967	57126884	57121899	57126927	JUNC00003085	3	+	68	43	-304.0	-304.0	-304.0
chrX	57127058	57214447	57127034	57214499	JUNC00003086	1	+	24	52	-304.0	-304.0	-304.0
chrX	57127802	57131856	57127752	57131882	JUNC00003087	1	+	50	26	-304.0	-304.0	-304.0
chrX	57136069	57136372	57136036	57136415	JUNC00003088	2	-	33	43	-304.0	-304.0	-304.0
chrX	57219481	57224247	57219439	57224281	JUNC00003089	1	+	42	34	-304.0	-304.0	-304.0
chrX	57224299	57224437	57224263	57224477	JUNC00003090	1	+	36	40	-304.0	-304.0	-304.0
chrX	57224299	57224502	57224271	57224550	JUNC00003091	1	+	28	48	-304.0	-304.0	-304.0
chrX	57287017	57290250	57286989	57290298	JUNC00003093	1	+	28	48	-304.0	-304.0	-304.0
chrX	57287017	57292497	57286958	57292548	JUNC00003092	9	+	59	51	-304.0	-304.0	-304.0
chrX	57290300	57292497	57290272	57292545	JUNC00003094	1	+	28	48	-304.0	-304.0	-304.0
chrX	57292580	57310592	57292518	57310662	JUNC00003095	9	+	62	70	-304.0	-304.0	-304.0
chrX	57310729	57331597	57310657	57331656	JUNC00003096	5	+	72	59	-304.0	-304.0	-304.0
chrX	57331807	57341270	57331736	57341343	JUNC00003097	4	+	71	73	-304.0	-304.0	-304.0
chrX	57341390	57378650	57341315	57378706	JUNC00003098	5	+	75	56	-304.0	-304.0	-304.0
chrX	57378786	57380911	57378730	57380930	JUNC00003099	1	+	56	19	-304.0	-304.0	-304.0
chrX	57381029	57431917	57380980	57431944	JUNC00003100	1	+	49	27	-304.0	-304.0	-304.0
chrX	57381029	57446927	57381008	57446986	JUNC00003101	2	+	21	59	-304.0	-304.0	-304.0
chrX	57432037	57446927	57431965	57446982	JUNC00003102	6	+	72	55	-304.0	-304.0	-304.0
chrX	57447039	57448523	57446964	57448584	JUNC00003103	12	+	75	61	-304.0	-304.0	-304.0
chrX	57448718	57481508	57448664	57481530	JUNC00003105	1	+	54	22	-304.0	-304.0	-304.0
chrX	57448718	57488756	57448656	57488783	JUNC00003104	2	+	62	27	-304.0	-304.0	-304.0
chrX	57481714	57488756	57481672	57488790	JUNC00003106	1	+	42	34	-304.0	-304.0	-304.0
chrX	57718370	57726067	57718321	57726094	JUNC00003107	1	+	49	27	-304.0	-304.0	-304.0
chrX	62749933	62750627	62749888	62750658	JUNC00003108	1	-	45	31	-304.0	-304.0	-304.0
chrX	63426996	63432363	63426924	63432426	JUNC00003109	15	-	72	63	-304.0	-304.0	-304.0
chrX	63428981	63432363	63428915	63432436	JUNC00003110	22	-	66	73	-304.0	-304.0	-304.0
chrX	63432491	63509943	63432435	63510007	JUNC00003113	3	-	56	64	-304.0	-304.0	-304.0
chrX	63432491	63516909	63432416	63516984	JUNC00003112	9	-	75	75	-304.0	-304.0	-304.0
chrX	63432491	63560831	63432416	63560898	JUNC00003111	24	-	75	67	-304.0	-304.0	-304.0
chrX	63432961	63560831	63432911	63560902	JUNC00003114	3	-	50	71	-304.0	-304.0	-304.0
chrX	63443132	63560831	63443087	63560862	JUNC00003115	1	-	45	31	-304.0	-304.0	-304.0
chrX	63510079	63560831	63510039	63560867	JUNC00003116	1	-	40	36	-304.0	-304.0	-304.0
chrX	63517082	63560831	63517011	63560897	JUNC00003117	10	-	71	66	-304.0	-304.0	-304.0
chrX	63638209	63643979	63638134	63644048	JUNC00003118	34	-	75	69	-304.0	-304.0	-304.0
chrX	63639619	63643979	63639579	63644015	JUNC00003120	1	-	40	36	-304.0	-304.0	-304.0
chrX	63644048	63655493	63643979	63655566	JUNC00003119	51	-	69	73	-304.0	-304.0	-304.0
chrX	63655737	63655944	63655662	63655996	JUNC00003121	6	-	75	52	-304.0	-304.0	-304.0
chrX	63655737	63665885	63655662	63665956	JUNC00003122	55	-	75	71	-304.0	-304.0	-304.0
chrX	63655737	63674037	63655663	63674068	JUNC00003123	2	-	74	31	-304.0	-304.0	-304.0
chrX	63656650	63657388	63656624	63657438	JUNC00003124	1	-	26	50	-304.0	-304.0	-304.0
chrX	63658064	63665885	63658016	63665917	JUNC00003125	2	-	48	32	-304.0	-304.0	-304.0
chrX	63666017	63674037	63665951	63674112	JUNC00003126	43	-	66	75	-304.0	-304.0	-304.0
chrX	63674167	63678339	63674092	63678411	JUNC00003127	39	-	75	72	-304.0	-304.0	-304.0
chrX	63678572	63697124	63678497	63697199	JUNC00003128	35	-	75	75	-304.0	-304.0	-304.0
chrX	63697304	63703169	63697256	63703228	JUNC00003130	2	-	48	59	-304.0	-304.0	-304.0
chrX	63697304	63706257	63697229	63706332	JUNC00003129	43	-	75	75	-304.0	-304.0	-304.0
chrX	63697304	63724531	63697284	63724587	JUNC00003131	1	-	20	56	-304.0	-304.0	-304.0
chrX	63703284	63706257	63703266	63706315	JUNC00003132	1	-	18	58	-304.0	-304.0	-304.0
chrX	63706449	63724531	63706379	63724597	JUNC00003133	47	-	70	66	-304.0	-304.0	-304.0
chrX	63706449	63754303	63706381	63754377	JUNC00003134	5	-	68	74	-304.0	-304.0	-304.0
chrX	63706449	63754307	63706399	63754333	JUNC00003135	1	-	50	26	-304.0	-304.0	-304.0
chrX	63706449	63754314	63706409	63754354	JUNC00003136	2	-	40	40	-304.0	-304.0	-304.0
chrX	63722897	63724531	63722869	63724579	JUNC00003137	1	-	28	48	-304.0	-304.0	-304.0
chrX	63724711	63727190	63724642	63727231	JUNC00003140	3	-	69	41	-304.0	-304.0	-304.0
chrX	63724711	63754303	63724642	63754376	JUNC00003139	5	-	69	73	-304.0	-304.0	-304.0
chrX	63724711	63754314	63724642	63754388	JUNC00003138	32	-	69	74	-304.0	-304.0	-304.0
chrX	63724711	63754920	63724664	63754949	JUNC00003143	1	-	47	29	-304.0	-304.0	-304.0
chrX	63724711	63755157	63724662	63755184	JUNC00003142	1	-	49	27	-304.0	-304.0	-304.0
chrX	63724711	63755833	63724678	63755876	JUNC00003144	1	-	33	43	-304.0	-304.0	-304.0
chrX	63724711	63785115	63724643	63785185	JUNC00003141	7	-	68	70	-304.0	-304.0	-304.0
chrX	63725735	63736989	63725687	63737016	JUNC00003145	1	-	48	27	-304.0	-304.0	-304.0
chrX	63754676	63754920	63754610	63754992	JUNC00003146	12	-	66	72	-304.0	-304.0	-304.0
chrX	64192307	64193138	64192257	64193164	JUNC00003147	1	-	50	26	-304.0	-304.0	-304.0
chrX	64193384	64205569	64193322	64205637	JUNC00003148	5	-	62	68	-304.0	-304.0	-304.0
chrX	64269043	64270946	64268996	64270975	JUNC00003149	1	-	47	29	-304.0	-304.0	-304.0
chrX	64271073	64328771	64271043	64328817	JUNC00003150	1	-	30	46	-304.0	-304.0	-304.0
chrX	64328900	64331556	64328839	64331603	JUNC00003151	3	-	61	47	-304.0	-304.0	-304.0
chrX	64331603	64345044	64331556	64345066	JUNC00003152	1	-	47	22	-304.0	-304.0	-304.0
chrX	64331757	64336078	64331688	64336129	JUNC00003153	3	-	69	51	-304.0	-304.0	-304.0
chrX	64331757	64337267	64331740	64337326	JUNC00003154	1	-	17	59	-304.0	-304.0	-304.0
chrX	64336128	64337267	64336076	64337320	JUNC00003155	3	-	52	53	-304.0	-304.0	-304.0
chrX	64337393	64343610	64337322	64343681	JUNC00003156	7	-	71	71	-304.0	-304.0	-304.0
chrX	64343720	64345044	64343663	64345114	JUNC00003157	8	-	57	70	-304.0	-304.0	-304.0
chrX	64345177	64348659	64345112	64348731	JUNC00003158	9	-	65	72	-304.0	-304.0	-304.0
chrX	64348794	64349941	64348743	64349969	JUNC00003159	2	-	51	28	-304.0	-304.0	-304.0
chrX	64350070	64354776	64350003	64354847	JUNC00003160	8	-	67	71	-304.0	-304.0	-304.0
chrX	64354934	64356175	64354902	64356232	JUNC00003161	3	-	32	57	-304.0	-304.0	-304.0
chrX	64356338	64359404	64356266	64359476	JUNC00003162	7	-	72	72	-304.0	-304.0	-304.0
chrX	64359527	64395339	64359469	64395405	JUNC00003163	7	-	58	66	-304.0	-304.0	-304.0
chrX	64843148	64844178	64843116	64844222	JUNC00003164	1	+	32	44	-304.0	-304.0	-304.0
chrX	64917896	64919041	64917824	64919114	JUNC00003165	25	-	72	73	-304.0	-304.0	-304.0
chrX	64919204	64920080	64919129	64920155	JUNC00003166	25	-	75	75	-304.0	-304.0	-304.0
chrX	64920253	64921816	64920178	64921883	JUNC00003167	33	-	75	67	-304.0	-304.0	-304.0
chrX	64921988	64976324	64921915	64976398	JUNC00003168	31	-	73	74	-304.0	-304.0	-304.0
chrX	65035269	65051461	65035247	65051515	JUNC00003169	1	+	22	54	-304.0	-304.0	-304.0
chrX	65075670	65075843	65075654	65075903	JUNC00003170	1	+	16	60	-304.0	-304.0	-304.0
chrX	65489409	65497131	65489363	65497161	JUNC00003171	1	+	46	30	-304.0	-304.0	-304.0
chrX	65512901	65514822	65512826	65514896	JUNC00003172	140	-	75	74	-304.0	-304.0	-304.0
chrX	65514970	65517986	65514896	65518061	JUNC00003173	14	-	74	75	-304.0	-304.0	-304.0
chrX	65514973	65517986	65514898	65518061	JUNC00003174	176	-	75	75	-304.0	-304.0	-304.0
chrX	65518465	65520701	65518413	65520725	JUNC00003176	1	-	52	24	-304.0	-304.0	-304.0
chrX	65518465	65523559	65518391	65523632	JUNC00003175	141	-	74	73	-304.0	-304.0	-304.0
chrX	65520817	65523559	65520747	65523612	JUNC00003177	2	-	70	53	-304.0	-304.0	-304.0
chrX	65521290	65523559	65521271	65523631	JUNC00003178	2	-	19	72	-304.0	-304.0	-304.0
chrX	65523707	65524055	65523633	65524130	JUNC00003179	167	-	74	75	-304.0	-304.0	-304.0
chrX	65524262	65524563	65524188	65524614	JUNC00003181	47	-	74	51	-304.0	-304.0	-304.0
chrX	65524262	65524584	65524223	65524614	JUNC00003182	1	-	39	30	-304.0	-304.0	-304.0
chrX	65524262	65524964	65524187	65525039	JUNC00003180	87	-	75	75	-304.0	-304.0	-304.0
chrX	65524277	65524560	65524232	65524591	JUNC00003184	1	?	45	31	-304.0	-304.0	-304.0
chrX	65524614	65524964	65524545	65525039	JUNC00003183	63	-	69	75	-304.0	-304.0	-304.0
chrX	65525050	65528259	65524977	65528334	JUNC00003185	149	-	73	75	-304.0	-304.0	-304.0
chrX	65525050	65529211	65524996	65529258	JUNC00003186	3	-	54	47	-304.0	-304.0	-304.0
chrX	65528369	65529211	65528294	65529259	JUNC00003188	119	-	75	48	-304.0	-304.0	-304.0
chrX	65529258	65529593	65529209	65529666	JUNC00003187	140	-	49	73	-304.0	-304.0	-304.0
chrX	65529878	65531356	65529803	65531430	JUNC00003189	152	-	75	74	-304.0	-304.0	-304.0
chrX	65531438	65532560	65531363	65532633	JUNC00003190	148	-	75	73	-304.0	-304.0	-304.0
chrX	65532630	65533609	65532559	65533684	JUNC00003191	157	-	71	75	-304.0	-304.0	-304.0
chrX	65532630	65534479	65532578	65534502	JUNC00003192	1	-	52	23	-304.0	-304.0	-304.0
chrX	65533730	65534474	65533655	65534509	JUNC00003193	3	-	75	35	-304.0	-304.0	-304.0
chrX	65533735	65534479	65533661	65534554	JUNC00003194	149	-	74	75	-304.0	-304.0	-304.0
chrX	65552180	65553414	65552131	65553441	JUNC00003195	1	-	49	27	-304.0	-304.0	-304.0
chrX	65598889	65703605	65598870	65703662	JUNC00003196	1	+	19	57	-304.0	-304.0	-304.0
chrX	65667853	65668344	65667778	65668380	JUNC00003200	5	+	75	36	-304.0	-304.0	-304.0
chrX	65667853	65701512	65667778	65701584	JUNC00003198	41	+	75	72	-304.0	-304.0	-304.0
chrX	65667853	65703585	65667779	65703659	JUNC00003201	11	+	74	74	-304.0	-304.0	-304.0
chrX	65667853	65703610	65667778	65703638	JUNC00003199	4	+	75	28	-304.0	-304.0	-304.0
chrX	65667853	65707689	65667813	65707725	JUNC00003203	1	+	40	36	-304.0	-304.0	-304.0
chrX	65667853	65716817	65667778	65716892	JUNC00003197	1646	+	75	75	-304.0	-304.0	-304.0
chrX	65667853	65716822	65667836	65716881	JUNC00003204	1	+	17	59	-304.0	-304.0	-304.0
chrX	65667853	65727813	65667779	65727888	JUNC00003202	8	+	74	75	-304.0	-304.0	-304.0
chrX	65668380	65716817	65668343	65716848	JUNC00003205	1	+	37	31	-304.0	-304.0	-304.0
chrX	65697079	65716817	65697014	65716892	JUNC00003206	12	+	65	75	-304.0	-304.0	-304.0
chrX	65697343	65716817	65697322	65716872	JUNC00003207	1	+	21	55	-304.0	-304.0	-304.0
chrX	65701641	65703605	65701602	65703677	JUNC00003208	2	+	39	72	-304.0	-304.0	-304.0
chrX	65701641	65703610	65701607	65703652	JUNC00003209	1	+	34	42	-304.0	-304.0	-304.0
chrX	65703691	65716817	65703622	65716890	JUNC00003210	19	+	69	73	-304.0	-304.0	-304.0
chrX	65707740	65716817	65707703	65716892	JUNC00003211	18	+	37	75	-304.0	-304.0	-304.0
chrX	65716901	65727813	65716826	65727888	JUNC00003212	1520	+	75	75	-304.0	-304.0	-304.0
chrX	65716901	65729437	65716826	65729512	JUNC00003213	65	+	75	75	-304.0	-304.0	-304.0
chrX	65727909	65729437	65727834	65729512	JUNC00003214	1702	+	75	75	-304.0	-304.0	-304.0
chrX	65729712	65731106	65729637	65731181	JUNC00003215	1622	+	75	75	-304.0	-304.0	-304.0
chrX	65731190	65731837	65731115	65731912	JUNC00003216	1352	+	75	75	-304.0	-304.0	-304.0
chrX	65731984	65733183	65731909	65733258	JUNC00003217	1640	+	75	75	-304.0	-304.0	-304.0
chrX	65731984	65735266	65731932	65735341	JUNC00003218	7	+	52	75	-304.0	-304.0	-304.0
chrX	65733280	65735266	65733205	65735341	JUNC00003219	1687	+	75	75	-304.0	-304.0	-304.0
chrX	65735430	65736794	65735355	65736869	JUNC00003220	2221	+	75	75	-304.0	-304.0	-304.0
chrX	65736925	65737177	65736850	65737252	JUNC00003221	2018	+	75	75	-304.0	-304.0	-304.0
chrX	65737338	65738524	65737263	65738599	JUNC00003222	2101	+	75	75	-304.0	-304.0	-304.0
chrX	65738617	65738969	65738542	65739044	JUNC00003223	2084	+	75	75	-304.0	-304.0	-304.0
chrX	65739194	65739728	65739119	65739803	JUNC00003224	1709	+	75	75	-304.0	-304.0	-304.0
chrX	65741063	65741199	65740990	65741230	JUNC00003225	8	?	73	31	-304.0	-304.0	-304.0
chrX	65821321	65821469	65821267	65821491	JUNC00003226	1	-	54	22	-304.0	-304.0	-304.0
chrX	66015551	66017064	66015509	66017098	JUNC00003227	1	+	42	34	-304.0	-304.0	-304.0
chrX	66015551	66018823	66015511	66018859	JUNC00003228	1	+	40	36	-304.0	-304.0	-304.0
chrX	66017189	66018823	66017163	66018873	JUNC00003229	1	+	26	50	-304.0	-304.0	-304.0
chrX	66164470	66170557	66164404	66170597	JUNC00003230	4	+	66	40	-304.0	-304.0	-304.0
chrX	66170737	66172354	66170677	66172408	JUNC00003231	3	+	60	54	-304.0	-304.0	-304.0
chrX	66172599	66173588	66172529	66173631	JUNC00003232	2	+	70	43	-304.0	-304.0	-304.0
chrX	66173801	66188358	66173747	66188430	JUNC00003233	2	+	54	72	-304.0	-304.0	-304.0
chrX	66188541	66189683	66188486	66189756	JUNC00003234	7	+	55	73	-304.0	-304.0	-304.0
chrX	66189938	66192129	66189874	66192193	JUNC00003235	5	+	64	64	-304.0	-304.0	-304.0
chrX	66192298	66193501	66192229	66193558	JUNC00003236	6	+	69	57	-304.0	-304.0	-304.0
chrX	66193638	66195097	66193591	66195126	JUNC00003237	1	+	47	29	-304.0	-304.0	-304.0
chrX	66193638	66260099	66193596	66260133	JUNC00003238	1	+	42	34	-304.0	-304.0	-304.0
chrX	66195229	66197682	66195206	66197740	JUNC00003239	2	+	23	58	-304.0	-304.0	-304.0
chrX	66197894	66198877	66197824	66198945	JUNC00003240	12	+	70	68	-304.0	-304.0	-304.0
chrX	66199028	66200539	66198956	66200605	JUNC00003241	10	+	72	66	-304.0	-304.0	-304.0
chrX	66200752	66203363	66200681	66203438	JUNC00003242	9	+	71	75	-304.0	-304.0	-304.0
chrX	66203577	66207194	66203506	66207264	JUNC00003243	12	+	71	70	-304.0	-304.0	-304.0
chrX	66207334	66208114	66207270	66208185	JUNC00003244	12	+	64	71	-304.0	-304.0	-304.0
chrX	66208246	66255034	66208175	66255097	JUNC00003245	5	+	71	63	-304.0	-304.0	-304.0
chrX	66255141	66256104	66255092	66256161	JUNC00003246	3	+	49	57	-304.0	-304.0	-304.0
chrX	66256330	66258839	66256262	66258912	JUNC00003247	10	+	68	73	-304.0	-304.0	-304.0
chrX	66258979	66260099	66258922	66260115	JUNC00003248	1	+	57	16	-304.0	-304.0	-304.0
chrX	66260262	66263643	66260197	66263688	JUNC00003249	14	+	65	45	-304.0	-304.0	-304.0
chrX	66262341	66263643	66262320	66263688	JUNC00003251	1	+	21	45	-304.0	-304.0	-304.0
chrX	66263688	66266439	66263640	66266477	JUNC00003250	10	+	48	38	-304.0	-304.0	-304.0
chrX	66598093	66599473	66598020	66599536	JUNC00003252	12	-	73	63	-304.0	-304.0	-304.0
chrX	66598093	66599768	66598030	66599834	JUNC00003253	14	-	63	66	-304.0	-304.0	-304.0
chrX	66598093	66602723	66598069	66602775	JUNC00003254	1	-	24	52	-304.0	-304.0	-304.0
chrX	66599860	66602632	66599811	66602702	JUNC00003256	3	-	49	70	-304.0	-304.0	-304.0
chrX	66599860	66602723	66599792	66602796	JUNC00003255	12	-	68	73	-304.0	-304.0	-304.0
chrX	66599866	66602632	66599811	66602660	JUNC00003257	3	-	55	28	-304.0	-304.0	-304.0
chrX	66599866	66602723	66599842	66602783	JUNC00003258	2	-	24	60	-304.0	-304.0	-304.0
chrX	66600095	66602723	66600045	66602749	JUNC00003259	1	-	50	26	-304.0	-304.0	-304.0
chrX	66602797	66604420	66602734	66604486	JUNC00003260	20	-	63	66	-304.0	-304.0	-304.0
chrX	66602797	66605047	66602757	66605083	JUNC00003261	1	-	40	36	-304.0	-304.0	-304.0
chrX	66603549	66604420	66603508	66604455	JUNC00003262	1	-	41	35	-304.0	-304.0	-304.0
chrX	66604506	66605047	66604434	66605122	JUNC00003263	31	-	72	75	-304.0	-304.0	-304.0
chrX	66605226	66615933	66605154	66616008	JUNC00003264	26	-	72	75	-304.0	-304.0	-304.0
chrX	66616030	66638918	66616002	66638966	JUNC00003267	1	-	28	48	-304.0	-304.0	-304.0
chrX	66616030	66638994	66615958	66639062	JUNC00003266	18	-	72	68	-304.0	-304.0	-304.0
chrX	66616030	66639200	66615955	66639269	JUNC00003265	10	-	75	69	-304.0	-304.0	-304.0
chrX	67686126	67711401	67686068	67711419	JUNC00003268	1	+	58	18	-304.0	-304.0	-304.0
chrX	68319508	68415787	68319463	68415813	JUNC00003269	1	+	45	26	-304.0	-304.0	-304.0
chrX	68354526	68359625	68354506	68359681	JUNC00003270	1	+	20	56	-304.0	-304.0	-304.0
chrX	68447831	68471256	68447802	68471303	JUNC00003271	1	-	29	47	-304.0	-304.0	-304.0
chrX	68475582	68495705	68475561	68495760	JUNC00003272	1	+	21	55	-304.0	-304.0	-304.0
chrX	68499123	68508137	68499061	68508160	JUNC00003274	2	+	62	23	-304.0	-304.0	-304.0
chrX	68499123	68510678	68499095	68510726	JUNC00003275	1	+	28	48	-304.0	-304.0	-304.0
chrX	68499123	68511848	68499048	68511921	JUNC00003273	30	+	75	73	-304.0	-304.0	-304.0
chrX	68511977	68513326	68511917	68513392	JUNC00003276	44	+	60	66	-304.0	-304.0	-304.0
chrX	68513405	68518769	68513332	68518812	JUNC00003277	35	+	73	43	-304.0	-304.0	-304.0
chrX	68518812	68521371	68518769	68521446	JUNC00003278	33	+	43	75	-304.0	-304.0	-304.0
chrX	68521497	68522759	68521424	68522832	JUNC00003279	53	+	73	73	-304.0	-304.0	-304.0
chrX	68522917	68531880	68522843	68531955	JUNC00003280	42	+	74	75	-304.0	-304.0	-304.0
chrX	68715375	68716367	68715327	68716395	JUNC00003281	1	+	48	28	-304.0	-304.0	-304.0
chrX	68716431	68717199	68716372	68717216	JUNC00003282	1	+	59	17	-304.0	-304.0	-304.0
chrX	68720423	68720923	68720396	68720972	JUNC00003283	1	+	27	49	-304.0	-304.0	-304.0
chrX	68721122	68721535	68721068	68721557	JUNC00003284	1	+	54	22	-304.0	-304.0	-304.0
chrX	68722161	68722421	68722134	68722470	JUNC00003285	1	+	27	49	-304.0	-304.0	-304.0
chrX	68722646	68723625	68722594	68723649	JUNC00003286	1	+	52	24	-304.0	-304.0	-304.0
chrX	68784514	68784586	68784481	68784661	JUNC00003287	4	-	33	75	-304.0	-304.0	-304.0
chrX	68829904	68838616	68829883	68838674	JUNC00003288	2	+	21	58	-304.0	-304.0	-304.0
chrX	68838894	68839663	68838875	68839720	JUNC00003289	1	+	19	57	-304.0	-304.0	-304.0
chrX	68839756	68839959	68839703	68840030	JUNC00003290	3	+	53	71	-304.0	-304.0	-304.0
chrX	68840088	68840241	68840068	68840297	JUNC00003291	1	+	20	56	-304.0	-304.0	-304.0
chrX	69161940	69162006	69161918	69162067	JUNC00003292	2	?	22	61	-304.0	-304.0	-304.0
chrX	69163134	69165371	69163103	69165417	JUNC00003294	2	-	31	46	-304.0	-304.0	-304.0
chrX	69163140	69165371	69163067	69165429	JUNC00003293	28	-	73	58	-304.0	-304.0	-304.0
chrX	69163298	69165371	69163280	69165429	JUNC00003295	1	-	18	58	-304.0	-304.0	-304.0
chrX	69719892	69722348	69719874	69722406	JUNC00003296	1	+	18	58	-304.0	-304.0	-304.0
chrX	70133540	70133722	70133492	70133750	JUNC00003297	1	+	48	28	-304.0	-304.0	-304.0
chrX	70134135	70134522	70134060	70134597	JUNC00003298	287	+	75	75	-304.0	-304.0	-304.0
chrX	70134816	70146632	70134741	70146705	JUNC00003300	305	+	75	73	-304.0	-304.0	-304.0
chrX	70134816	70148760	70134747	70148832	JUNC00003301	5	+	69	72	-304.0	-304.0	-304.0
chrX	70134816	70165832	70134741	70165907	JUNC00003299	13	+	75	75	-304.0	-304.0	-304.0
chrX	70146828	70148760	70146753	70148833	JUNC00003302	283	+	75	73	-304.0	-304.0	-304.0
chrX	70148840	70150195	70148818	70150249	JUNC00003305	1	+	22	54	-304.0	-304.0	-304.0
chrX	70148840	70150209	70148765	70150284	JUNC00003304	423	+	75	75	-304.0	-304.0	-304.0
chrX	70148840	70165832	70148765	70165896	JUNC00003303	13	+	75	64	-304.0	-304.0	-304.0
chrX	70150322	70162345	70150247	70162405	JUNC00003307	17	+	75	60	-304.0	-304.0	-304.0
chrX	70150322	70165832	70150247	70165907	JUNC00003306	501	+	75	75	-304.0	-304.0	-304.0
chrX	70162464	70165832	70162399	70165907	JUNC00003308	34	+	65	75	-304.0	-304.0	-304.0
chrX	70199882	70200254	70199865	70200313	JUNC00003309	1	+	17	59	-304.0	-304.0	-304.0
chrX	70204516	70204951	70204485	70204996	JUNC00003310	1	+	31	45	-304.0	-304.0	-304.0
chrX	70278436	70278739	70278398	70278777	JUNC00003311	1	-	38	38	-304.0	-304.0	-304.0
chrX	70280910	70281646	70280893	70281705	JUNC00003313	1	-	17	59	-304.0	-304.0	-304.0
chrX	70280910	70282209	70280866	70282241	JUNC00003312	1	-	44	32	-304.0	-304.0	-304.0
chrX	70281743	70282209	70281701	70282243	JUNC00003314	1	-	42	34	-304.0	-304.0	-304.0
chrX	70282275	70287275	70282230	70287336	JUNC00003315	3	-	45	61	-304.0	-304.0	-304.0
chrX	70286768	70286985	70286723	70287017	JUNC00003317	2	-	45	32	-304.0	-304.0	-304.0
chrX	70287116	70287275	70287041	70287338	JUNC00003318	221	-	75	63	-304.0	-304.0	-304.0
chrX	70287336	70287731	70287275	70287806	JUNC00003316	195	-	61	75	-304.0	-304.0	-304.0
chrX	70287830	70288116	70287755	70288176	JUNC00003319	165	-	75	60	-304.0	-304.0	-304.0
chrX	70288173	70288429	70288115	70288502	JUNC00003320	187	-	58	73	-304.0	-304.0	-304.0
chrX	70288513	70289254	70288439	70289328	JUNC00003321	237	-	74	74	-304.0	-304.0	-304.0
chrX	70289354	70289521	70289282	70289593	JUNC00003323	31	-	72	72	-304.0	-304.0	-304.0
chrX	70289354	70289859	70289279	70289925	JUNC00003322	148	-	75	66	-304.0	-304.0	-304.0
chrX	70289593	70289859	70289520	70289892	JUNC00003324	18	-	73	33	-304.0	-304.0	-304.0
chrX	70289621	70289859	70289577	70289913	JUNC00003325	2	-	44	54	-304.0	-304.0	-304.0
chrX	70290150	70290437	70290076	70290509	JUNC00003326	42	+	74	72	-304.0	-304.0	-304.0
chrX	70290150	70290753	70290128	70290805	JUNC00003327	1	+	22	52	-304.0	-304.0	-304.0
chrX	70290578	70290690	70290503	70290761	JUNC00003329	52	+	75	71	-304.0	-304.0	-304.0
chrX	70290805	70296997	70290731	70297060	JUNC00003328	38	+	74	63	-304.0	-304.0	-304.0
chrX	70297188	70299112	70297118	70299181	JUNC00003330	24	+	70	69	-304.0	-304.0	-304.0
chrX	70299202	70301899	70299127	70301973	JUNC00003331	46	+	75	74	-304.0	-304.0	-304.0
chrX	70302066	70302303	70301991	70302378	JUNC00003332	59	+	75	75	-304.0	-304.0	-304.0
chrX	70302398	70329404	70302323	70329477	JUNC00003333	46	+	75	73	-304.0	-304.0	-304.0
chrX	70329521	70330156	70329447	70330229	JUNC00003334	51	+	74	73	-304.0	-304.0	-304.0
chrX	70330332	70333627	70330257	70333689	JUNC00003335	64	+	75	62	-304.0	-304.0	-304.0
chrX	70333689	70341798	70333624	70341873	JUNC00003336	53	+	65	75	-304.0	-304.0	-304.0
chrX	70341931	70343702	70341857	70343761	JUNC00003337	53	+	74	59	-304.0	-304.0	-304.0
chrX	70343761	70343876	70343702	70343949	JUNC00003338	57	+	59	73	-304.0	-304.0	-304.0
chrX	70343982	70352599	70343908	70352656	JUNC00003339	56	+	74	57	-304.0	-304.0	-304.0
chrX	70345232	70350129	70345212	70350185	JUNC00003341	1	+	20	56	-304.0	-304.0	-304.0
chrX	70352656	70353621	70352599	70353696	JUNC00003340	61	+	57	75	-304.0	-304.0	-304.0
chrX	70353807	70374150	70353733	70374225	JUNC00003342	66	+	74	75	-304.0	-304.0	-304.0
chrX	70374254	70375203	70374179	70375276	JUNC00003343	53	+	75	73	-304.0	-304.0	-304.0
chrX	70375348	70376099	70375276	70376174	JUNC00003344	84	+	72	75	-304.0	-304.0	-304.0
chrX	70376210	70386617	70376135	70386690	JUNC00003345	68	+	75	73	-304.0	-304.0	-304.0
chrX	70386701	70387183	70386626	70387255	JUNC00003346	79	+	75	72	-304.0	-304.0	-304.0
chrX	70387297	70391632	70387238	70391653	JUNC00003348	3	+	59	21	-304.0	-304.0	-304.0
chrX	70387297	70395670	70387226	70395745	JUNC00003347	99	+	71	75	-304.0	-304.0	-304.0
chrX	70391653	70395670	70391632	70395745	JUNC00003349	4	+	21	75	-304.0	-304.0	-304.0
chrX	70395826	70395948	70395758	70396023	JUNC00003350	63	+	68	75	-304.0	-304.0	-304.0
chrX	70396049	70402565	70395975	70402639	JUNC00003351	57	+	74	74	-304.0	-304.0	-304.0
chrX	70400855	70401488	70400834	70401543	JUNC00003352	1	-	21	55	128.0	108.0	128.0
chrX	70402695	70403863	70402621	70403938	JUNC00003353	64	+	74	75	-304.0	-304.0	-304.0
chrX	70404034	70404714	70403959	70404789	JUNC00003354	87	+	75	75	-304.0	-304.0	-304.0
chrX	70404822	70405827	70404747	70405902	JUNC00003355	70	+	75	75	-304.0	-304.0	-304.0
chrX	70405905	70406258	70405830	70406332	JUNC00003356	68	+	75	74	-304.0	-304.0	-304.0
chrX	70405905	70406892	70405841	70406914	JUNC00003357	2	+	64	22	-304.0	-304.0	-304.0
chrX	70406354	70406892	70406283	70406967	JUNC00003358	82	+	71	75	-304.0	-304.0	-304.0
chrX	70407075	70417887	70407001	70417959	JUNC00003359	78	+	74	72	-304.0	-304.0	-304.0
chrX	70418004	70419660	70417934	70419732	JUNC00003360	59	+	70	72	-304.0	-304.0	-304.0
chrX	70419783	70420061	70419713	70420133	JUNC00003361	51	+	70	72	-304.0	-304.0	-304.0
chrX	70450305	70450638	70450285	70450694	JUNC00003362	1	+	20	56	-304.0	-304.0	-304.0
chrX	70453306	70455944	70453250	70455964	JUNC00003363	1	-	56	20	-304.0	-304.0	-304.0
chrX	70455263	70455983	70455203	70455999	JUNC00003364	1	+	60	16	-304.0	-304.0	-304.0
chrX	70455263	70479149	70455209	70479214	JUNC00003365	9	+	54	65	-304.0	-304.0	-304.0
chrX	70456102	70479149	70456047	70479188	JUNC00003366	4	+	55	39	-304.0	-304.0	-304.0
chrX	70467617	70468513	70467566	70468538	JUNC00003367	1	+	51	25	-304.0	-304.0	-304.0
chrX	70467617	70473612	70467585	70473656	JUNC00003368	1	+	32	44	-304.0	-304.0	-304.0
chrX	70479264	70492106	70479190	70492170	JUNC00003369	15	+	74	64	-304.0	-304.0	-304.0
chrX	70492283	70492520	70492216	70492593	JUNC00003370	17	+	67	73	-304.0	-304.0	-304.0
chrX	70492596	70493375	70492523	70493450	JUNC00003371	31	+	73	75	-304.0	-304.0	-304.0
chrX	70493475	70497179	70493403	70497221	JUNC00003372	29	+	72	42	-304.0	-304.0	-304.0
chrX	70493475	70498519	70493411	70498570	JUNC00003373	7	+	64	51	-304.0	-304.0	-304.0
chrX	70497221	70498519	70497179	70498570	JUNC00003374	25	+	42	51	-304.0	-304.0	-304.0
chrX	70498570	70499175	70498519	70499247	JUNC00003375	23	+	51	72	-304.0	-304.0	-304.0
chrX	70499277	70499876	70499205	70499942	JUNC00003376	13	+	72	66	-304.0	-304.0	-304.0
chrX	70500049	70500470	70499982	70500544	JUNC00003377	23	+	67	74	-304.0	-304.0	-304.0
chrX	70500580	70500897	70500510	70500966	JUNC00003378	20	+	70	69	-304.0	-304.0	-304.0
chrX	70500989	70502162	70500918	70502236	JUNC00003379	24	+	71	74	-304.0	-304.0	-304.0
chrX	70909477	70913270	70909424	70913290	JUNC00003380	1	+	53	20	-304.0	-304.0	-304.0
chrX	70963231	70963259	70963175	70963279	JUNC00003381	1	?	56	20	96.0	96.0	96.0
chrX	70988911	71042122	70988891	71042178	JUNC00003382	1	+	20	56	108.0	124.0	124.0
chrX	71027582	71029308	71027513	71029367	JUNC00003383	3	-	69	59	-304.0	-304.0	-304.0
chrX	71029426	71033958	71029354	71034022	JUNC00003384	3	-	72	64	-304.0	-304.0	-304.0
chrX	71036367	71052816	71036324	71052870	JUNC00003385	2	-	43	54	-304.0	-304.0	-304.0
chrX	71052960	71053292	71052934	71053342	JUNC00003386	1	-	26	50	-304.0	-304.0	-304.0
chrX	71059712	71059739	71059680	71059812	JUNC00003387	3	-	32	73	98.0	98.0	98.0
chrX	71061118	71061842	71061044	71061917	JUNC00003388	115	-	74	75	-304.0	-304.0	-304.0
chrX	71061118	71062853	71061096	71062928	JUNC00003389	5	-	22	75	-304.0	-304.0	-304.0
chrX	71061967	71062853	71061892	71062928	JUNC00003390	128	-	75	75	-304.0	-304.0	-304.0
chrX	71062949	71068141	71062874	71068214	JUNC00003391	126	-	75	73	-304.0	-304.0	-304.0
chrX	71062949	71068153	71062874	71068208	JUNC00003392	2	-	75	55	-304.0	-304.0	-304.0
chrX	71067072	71068141	71067036	71068181	JUNC00003393	1	-	36	40	-304.0	-304.0	-304.0
chrX	71068322	71073276	71068247	71073329	JUNC00003394	3	-	75	53	-304.0	-304.0	-304.0
chrX	71078664	71178840	71078644	71178896	JUNC00003395	1	+	20	56	-304.0	-304.0	-304.0
chrX	71089049	71105494	71089012	71105533	JUNC00003396	1	+	37	39	-304.0	-304.0	-304.0
chrX	71096981	71098099	71096964	71098158	JUNC00003398	1	+	17	59	-304.0	-304.0	-304.0
chrX	71096981	71100683	71096921	71100757	JUNC00003397	4	+	60	74	-304.0	-304.0	-304.0
chrX	71101740	71102076	71101669	71102146	JUNC00003399	14	+	71	70	-304.0	-304.0	-304.0
chrX	71104112	71104297	71104040	71104372	JUNC00003400	5	-	72	75	-304.0	-304.0	-304.0
chrX	71104125	71104378	71104082	71104425	JUNC00003401	2	+	43	47	-304.0	-304.0	-304.0
chrX	71104404	71104768	71104332	71104828	JUNC00003402	11	-	72	60	-304.0	-304.0	-304.0
chrX	71104837	71105999	71104785	71106046	JUNC00003403	4	-	52	47	-304.0	-304.0	-304.0
chrX	71104837	71108276	71104801	71108346	JUNC00003404	10	-	36	70	-304.0	-304.0	-304.0
chrX	71105629	71105999	71105590	71106028	JUNC00003406	1	-	39	29	-304.0	-304.0	-304.0
chrX	71106137	71106358	71106109	71106406	JUNC00003407	1	-	28	48	-304.0	-304.0	-304.0
chrX	71106137	71108276	71106112	71108327	JUNC00003408	1	-	25	51	-304.0	-304.0	-304.0
chrX	71106426	71106531	71106384	71106578	JUNC00003409	2	-	42	47	-304.0	-304.0	-304.0
chrX	71106770	71107603	71106751	71107660	JUNC00003410	1	-	19	57	-304.0	-304.0	-304.0
chrX	71107762	71107834	71107692	71107887	JUNC00003412	3	?	70	53	-304.0	-304.0	-304.0
chrX	71107764	71107835	71107692	71107883	JUNC00003411	10	?	72	48	-304.0	-304.0	-304.0
chrX	71107769	71107841	71107730	71107877	JUNC00003413	1	?	39	36	-304.0	-304.0	-304.0
chrX	71107921	71108276	71107846	71108347	JUNC00003414	988	-	75	71	-304.0	-304.0	-304.0
chrX	71108346	71108598	71108275	71108673	JUNC00003405	1110	-	71	75	-304.0	-304.0	-304.0
chrX	71108346	71108620	71108276	71108695	JUNC00003416	22	-	70	75	-304.0	-304.0	-304.0
chrX	71108346	71109227	71108276	71109302	JUNC00003415	48	-	70	75	-304.0	-304.0	-304.0
chrX	71108693	71109227	71108618	71109278	JUNC00003417	26	-	75	51	-304.0	-304.0	-304.0
chrX	71108695	71109227	71108620	71109301	JUNC00003418	880	-	75	74	-304.0	-304.0	-304.0
chrX	71109390	71110155	71109315	71110230	JUNC00003419	958	-	75	75	-304.0	-304.0	-304.0
chrX	71109390	71110503	71109315	71110578	JUNC00003421	18	-	75	75	-304.0	-304.0	-304.0
chrX	71109390	71111424	71109315	71111490	JUNC00003420	9	-	75	66	-304.0	-304.0	-304.0
chrX	71109424	71110503	71109385	71110540	JUNC00003422	1	-	39	37	-304.0	-304.0	-304.0
chrX	71110295	71110503	71110220	71110578	JUNC00003423	1163	-	75	75	-304.0	-304.0	-304.0
chrX	71110332	71110503	71110298	71110578	JUNC00003424	2	-	34	75	-304.0	-304.0	-304.0
chrX	71110688	71110896	71110613	71110971	JUNC00003425	1080	-	75	75	-304.0	-304.0	-304.0
chrX	71111050	71111396	71110976	71111445	JUNC00003427	20	-	74	49	-304.0	-304.0	-304.0
chrX	71111050	71111424	71110975	71111499	JUNC00003426	1097	-	75	75	-304.0	-304.0	-304.0
chrX	71111494	71121358	71111424	71121413	JUNC00003428	6	-	70	55	-304.0	-304.0	-304.0
chrX	71118853	71119372	71118782	71119447	JUNC00003429	15	+	71	75	-304.0	-304.0	-304.0
chrX	71119477	71119685	71119405	71119757	JUNC00003430	44	+	72	72	-304.0	-304.0	-304.0
chrX	71119877	71120013	71119803	71120084	JUNC00003431	44	+	74	71	-304.0	-304.0	-304.0
chrX	71120170	71120970	71120095	71121039	JUNC00003432	51	+	75	69	-304.0	-304.0	-304.0
chrX	71121152	71121326	71121080	71121396	JUNC00003433	67	+	72	70	-304.0	-304.0	-304.0
chrX	71121437	71121561	71121362	71121636	JUNC00003434	70	+	75	75	-304.0	-304.0	-304.0
chrX	71121816	71122199	71121745	71122273	JUNC00003435	55	+	71	74	-304.0	-304.0	-304.0
chrX	71121816	71122507	71121771	71122538	JUNC00003436	1	+	45	31	-304.0	-304.0	-304.0
chrX	71122346	71122507	71122272	71122575	JUNC00003437	76	+	74	68	-304.0	-304.0	-304.0
chrX	71122607	71122737	71122532	71122811	JUNC00003438	70	+	75	74	-304.0	-304.0	-304.0
chrX	71122854	71123062	71122829	71123131	JUNC00003440	5	-	25	69	-304.0	-304.0	-304.0
chrX	71122874	71123094	71122799	71123169	JUNC00003439	68	+	75	75	-304.0	-304.0	-304.0
chrX	71123193	71140735	71123118	71140763	JUNC00003441	4	-	75	28	-304.0	-304.0	-304.0
chrX	71123226	71123593	71123153	71123668	JUNC00003442	105	+	73	75	-304.0	-304.0	-304.0
chrX	71123720	71124158	71123645	71124233	JUNC00003443	77	+	75	75	-304.0	-304.0	-304.0
chrX	71124388	71124763	71124317	71124836	JUNC00003444	48	+	71	73	-304.0	-304.0	-304.0
chrX	71124844	71124975	71124769	71125050	JUNC00003445	52	+	75	75	-304.0	-304.0	-304.0
chrX	71125146	71125350	71125071	71125425	JUNC00003446	54	+	75	75	-304.0	-304.0	-304.0
chrX	71125495	71125662	71125421	71125715	JUNC00003447	80	+	74	53	-304.0	-304.0	-304.0
chrX	71125713	71126035	71125661	71126109	JUNC00003448	47	+	52	74	-304.0	-304.0	-304.0
chrX	71126154	71126340	71126081	71126413	JUNC00003449	63	+	73	73	-304.0	-304.0	-304.0
chrX	71126484	71126968	71126409	71127041	JUNC00003450	60	+	75	73	-304.0	-304.0	-304.0
chrX	71127132	71127335	71127060	71127406	JUNC00003451	57	+	72	71	-304.0	-304.0	-304.0
chrX	71127428	71150282	71127399	71150329	JUNC00003454	1	-	29	47	-304.0	-304.0	-304.0
chrX	71127467	71127847	71127393	71127891	JUNC00003453	3	+	74	44	-304.0	-304.0	-304.0
chrX	71127467	71127892	71127393	71127967	JUNC00003452	56	+	74	75	-304.0	-304.0	-304.0
chrX	71128120	71128295	71128050	71128366	JUNC00003455	72	+	70	71	-304.0	-304.0	-304.0
chrX	71128440	71128597	71128365	71128672	JUNC00003456	62	+	75	75	-304.0	-304.0	-304.0
chrX	71128718	71129113	71128645	71129185	JUNC00003457	54	+	73	72	-304.0	-304.0	-304.0
chrX	71129215	71129315	71129142	71129389	JUNC00003458	71	+	73	74	-304.0	-304.0	-304.0
chrX	71129429	71129679	71129354	71129754	JUNC00003459	53	+	75	75	-304.0	-304.0	-304.0
chrX	71129855	71130034	71129782	71130109	JUNC00003460	62	+	73	75	-304.0	-304.0	-304.0
chrX	71130214	71131549	71130140	71131622	JUNC00003461	73	+	74	73	-304.0	-304.0	-304.0
chrX	71131621	71132072	71131546	71132146	JUNC00003462	72	+	75	74	-304.0	-304.0	-304.0
chrX	71132206	71132376	71132131	71132451	JUNC00003463	79	+	75	75	-304.0	-304.0	-304.0
chrX	71132538	71132844	71132463	71132919	JUNC00003464	101	+	75	75	-304.0	-304.0	-304.0
chrX	71132956	71133122	71132881	71133195	JUNC00003465	80	+	75	73	-304.0	-304.0	-304.0
chrX	71133212	71134356	71133137	71134429	JUNC00003466	72	+	75	73	-304.0	-304.0	-304.0
chrX	71134466	71134712	71134392	71134786	JUNC00003467	70	+	74	74	-304.0	-304.0	-304.0
chrX	71134848	71135091	71134773	71135165	JUNC00003468	84	+	75	74	-304.0	-304.0	-304.0
chrX	71136655	71136878	71136580	71136953	JUNC00003469	82	+	75	75	-304.0	-304.0	-304.0
chrX	71137029	71137186	71136955	71137257	JUNC00003470	59	+	74	71	-304.0	-304.0	-304.0
chrX	71137383	71137557	71137312	71137628	JUNC00003471	18	+	71	71	-304.0	-304.0	-304.0
chrX	71137392	71137557	71137317	71137628	JUNC00003472	32	+	75	71	-304.0	-304.0	-304.0
chrX	71137392	71137560	71137350	71137597	JUNC00003473	2	+	42	37	-304.0	-304.0	-304.0
chrX	71137635	71137725	71137560	71137799	JUNC00003474	59	+	75	74	-304.0	-304.0	-304.0
chrX	71137780	71137855	71137725	71137891	JUNC00003475	4	+	55	36	-304.0	-304.0	-304.0
chrX	71137943	71140634	71137869	71140708	JUNC00003476	87	+	74	74	-304.0	-304.0	-304.0
chrX	71140857	71141229	71140784	71141304	JUNC00003477	35	+	73	75	-304.0	-304.0	-304.0
chrX	71140857	71141232	71140828	71141284	JUNC00003478	2	+	29	52	-304.0	-304.0	-304.0
chrX	71141370	71141882	71141295	71141957	JUNC00003479	51	+	75	75	-304.0	-304.0	-304.0
chrX	71141964	71142174	71141889	71142245	JUNC00003480	76	+	75	71	-304.0	-304.0	-304.0
chrX	71143944	71147549	71143918	71147599	JUNC00003481	1	+	26	50	-304.0	-304.0	-304.0
chrX	71148206	71148845	71148179	71148906	JUNC00003482	2	+	27	61	-304.0	-304.0	-304.0
chrX	71150375	71151183	71150353	71151237	JUNC00003483	1	-	22	54	-304.0	-304.0	-304.0
chrX	71151306	71153913	71151254	71153937	JUNC00003484	1	-	52	24	-304.0	-304.0	-304.0
chrX	71153536	71155213	71153482	71155232	JUNC00003485	1	+	54	19	-304.0	-304.0	-304.0
chrX	71154582	71183910	71154559	71183963	JUNC00003486	1	-	23	53	-304.0	-304.0	-304.0
chrX	71155363	71164142	71155312	71164167	JUNC00003487	1	+	51	25	-304.0	-304.0	-304.0
chrX	71184013	71197908	71183947	71197974	JUNC00003489	4	-	66	66	-304.0	-304.0	-304.0
chrX	71184017	71197908	71183942	71197982	JUNC00003488	15	-	75	74	-304.0	-304.0	-304.0
chrX	71203518	71206446	71203498	71206495	JUNC00003490	1	+	20	49	-304.0	-304.0	-304.0
chrX	71220262	71261588	71220221	71261621	JUNC00003491	1	-	41	33	-304.0	-304.0	-304.0
chrX	71241108	71241226	71241033	71241301	JUNC00003492	116	-	75	75	-304.0	-304.0	-304.0
chrX	71241344	71242169	71241269	71242244	JUNC00003493	80	-	75	75	-304.0	-304.0	-304.0
chrX	71242424	71242969	71242349	71243044	JUNC00003494	82	-	75	75	-304.0	-304.0	-304.0
chrX	71243084	71243828	71243017	71243903	JUNC00003495	76	-	67	75	-304.0	-304.0	-304.0
chrX	71243980	71244301	71243905	71244373	JUNC00003496	75	-	75	72	-304.0	-304.0	-304.0
chrX	71244470	71244789	71244397	71244864	JUNC00003497	68	-	73	75	-304.0	-304.0	-304.0
chrX	71244893	71245338	71244822	71245412	JUNC00003498	70	-	71	74	-304.0	-304.0	-304.0
chrX	71245485	71245667	71245411	71245739	JUNC00003499	106	-	74	72	-304.0	-304.0	-304.0
chrX	71245842	71245985	71245767	71246060	JUNC00003500	115	-	75	75	-304.0	-304.0	-304.0
chrX	71246098	71246352	71246023	71246423	JUNC00003501	74	-	75	71	-304.0	-304.0	-304.0
chrX	71246512	71246594	71246458	71246668	JUNC00003503	13	-	54	74	-304.0	-304.0	-304.0
chrX	71246512	71246630	71246457	71246692	JUNC00003502	7	-	55	62	-304.0	-304.0	-304.0
chrX	71246692	71247344	71246617	71247419	JUNC00003504	73	-	75	75	-304.0	-304.0	-304.0
chrX	71247510	71247733	71247435	71247808	JUNC00003505	86	-	75	75	-304.0	-304.0	-304.0
chrX	71247906	71248161	71247831	71248235	JUNC00003506	81	-	75	74	-304.0	-304.0	-304.0
chrX	71248312	71248437	71248238	71248508	JUNC00003507	78	-	74	71	-304.0	-304.0	-304.0
chrX	71248524	71248685	71248449	71248756	JUNC00003508	80	-	75	71	-304.0	-304.0	-304.0
chrX	71248801	71249018	71248726	71249091	JUNC00003509	67	-	75	73	-304.0	-304.0	-304.0
chrX	71249169	71249460	71249094	71249535	JUNC00003510	73	-	75	75	-304.0	-304.0	-304.0
chrX	71249679	71250025	71249605	71250100	JUNC00003511	77	-	74	75	-304.0	-304.0	-304.0
chrX	71250203	71250431	71250132	71250502	JUNC00003512	84	-	71	71	-304.0	-304.0	-304.0
chrX	71250726	71251177	71250651	71251244	JUNC00003513	70	-	75	67	-304.0	-304.0	-304.0
chrX	71251244	71251557	71251177	71251604	JUNC00003514	95	-	67	47	-304.0	-304.0	-304.0
chrX	71251601	71252588	71251557	71252663	JUNC00003515	104	-	44	75	-304.0	-304.0	-304.0
chrX	71253274	71254028	71253201	71254097	JUNC00003516	36	-	73	69	-304.0	-304.0	-304.0
chrX	71253274	71254467	71253229	71254519	JUNC00003519	2	-	45	52	-304.0	-304.0	-304.0
chrX	71253274	71254480	71253205	71254528	JUNC00003517	4	-	69	48	-304.0	-304.0	-304.0
chrX	71253274	71254658	71253219	71254698	JUNC00003518	4	-	55	40	-304.0	-304.0	-304.0
chrX	71255000	71283614	71254960	71283666	JUNC00003520	2	+	40	52	-304.0	-304.0	-304.0
chrX	71258208	71311843	71258149	71311858	JUNC00003522	1	-	59	15	-304.0	-304.0	-304.0
chrX	71258208	71313552	71258149	71313567	JUNC00003521	1	-	59	15	-304.0	-304.0	-304.0
chrX	71258208	71317672	71258149	71317687	JUNC00003523	1	-	59	15	-304.0	118.0	118.0
chrX	71258226	71290297	71258203	71290345	JUNC00003524	1	-	23	48	-304.0	-304.0	-304.0
chrX	71265064	71266534	71265005	71266559	JUNC00003525	2	+	59	25	-304.0	-304.0	-304.0
chrX	71266727	71272284	71266678	71272345	JUNC00003526	3	+	49	61	-304.0	-304.0	-304.0
chrX	71283721	71284396	71283646	71284454	JUNC00003527	693	+	75	58	-304.0	-304.0	-304.0
chrX	71283721	71290628	71283650	71290703	JUNC00003528	73	+	71	75	-304.0	-304.0	-304.0
chrX	71284453	71284983	71284395	71285058	JUNC00003530	39	+	58	75	-304.0	-304.0	-304.0
chrX	71284453	71290610	71284433	71290666	JUNC00003531	1	+	20	56	-304.0	-304.0	-304.0
chrX	71284453	71290628	71284395	71290703	JUNC00003529	633	+	58	75	-304.0	-304.0	-304.0
chrX	71285097	71290628	71285022	71290703	JUNC00003532	32	+	75	75	-304.0	-304.0	-304.0
chrX	71289523	71343563	71289505	71343619	JUNC00003533	1	-	18	56	-304.0	-304.0	-304.0
chrX	71289568	71300592	71289528	71300667	JUNC00003534	57	+	40	75	-304.0	-304.0	-304.0
chrX	71290791	71291778	71290716	71291853	JUNC00003535	766	+	75	75	-304.0	-304.0	-304.0
chrX	71290806	71291778	71290774	71291822	JUNC00003536	1	+	32	44	-304.0	-304.0	-304.0
chrX	71291972	71294226	71291897	71294301	JUNC00003537	787	+	75	75	-304.0	-304.0	-304.0
chrX	71291972	71294397	71291943	71294472	JUNC00003538	6	+	29	75	-304.0	-304.0	-304.0
chrX	71294348	71296564	71294296	71296628	JUNC00003540	2	+	52	64	-304.0	-304.0	-304.0
chrX	71294348	71296850	71294273	71296925	JUNC00003539	6	+	75	75	-304.0	-304.0	-304.0
chrX	71294528	71296564	71294453	71296639	JUNC00003541	1142	+	75	75	-304.0	-304.0	-304.0
chrX	71296660	71296850	71296585	71296925	JUNC00003542	822	+	75	75	-304.0	-304.0	-304.0
chrX	71297047	71297360	71297015	71297404	JUNC00003544	1	+	32	44	-304.0	-304.0	-304.0
chrX	71297047	71297376	71296972	71297451	JUNC00003543	1447	+	75	75	-304.0	-304.0	-304.0
chrX	71297461	71297587	71297386	71297607	JUNC00003546	8	+	75	20	-304.0	-304.0	-304.0
chrX	71297461	71297835	71297386	71297910	JUNC00003545	1631	+	75	75	-304.0	-304.0	-304.0
chrX	71297938	71298468	71297863	71298510	JUNC00003547	1496	+	75	42	-304.0	-304.0	-304.0
chrX	71298507	71298685	71298472	71298726	JUNC00003549	1	?	35	41	-304.0	-304.0	-304.0
chrX	71298508	71298706	71298435	71298781	JUNC00003548	1247	+	73	75	-304.0	-304.0	-304.0
chrX	71298816	71299941	71298741	71300016	JUNC00003550	879	+	75	75	-304.0	-304.0	-304.0
chrX	71302333	71302410	71302311	71302467	JUNC00003551	2	+	22	57	-304.0	-304.0	-304.0
chrX	71302556	71303261	71302481	71303305	JUNC00003552	2	+	75	44	-304.0	-304.0	-304.0
chrX	71303516	71303626	71303477	71303663	JUNC00003553	1	+	39	37	-304.0	-304.0	-304.0
chrX	71303697	71303811	71303681	71303871	JUNC00003554	1	+	16	60	-304.0	-304.0	-304.0
chrX	71303911	71304186	71303852	71304259	JUNC00003555	5	+	59	73	-304.0	-304.0	-304.0
chrX	71304300	71304541	71304228	71304604	JUNC00003556	7	+	72	63	-304.0	-304.0	-304.0
chrX	71304604	71304964	71304558	71305008	JUNC00003557	2	+	46	44	-304.0	-304.0	-304.0
chrX	71313570	71343579	71313538	71343623	JUNC00003558	1	-	32	44	-304.0	112.0	112.0
chrX	71319608	71374560	71319570	71374598	JUNC00003559	1	-	38	38	-304.0	-304.0	-304.0
chrX	71352919	71361404	71352881	71361442	JUNC00003560	1	+	38	38	-304.0	-304.0	-304.0
chrX	71366494	71367498	71366420	71367571	JUNC00003561	41	+	74	73	-304.0	-304.0	-304.0
chrX	71367600	71368053	71367580	71368109	JUNC00003563	1	+	20	56	-304.0	-304.0	-304.0
chrX	71367613	71368053	71367539	71368128	JUNC00003562	59	+	74	75	-304.0	-304.0	-304.0
chrX	71368170	71375166	71368096	71375238	JUNC00003564	70	+	74	72	-304.0	-304.0	-304.0
chrX	71375286	71376949	71375213	71377021	JUNC00003565	49	+	73	72	-304.0	-304.0	-304.0
chrX	71375286	71377012	71375240	71377087	JUNC00003566	6	+	46	75	-304.0	-304.0	-304.0
chrX	71377191	71377602	71377117	71377677	JUNC00003567	46	+	74	75	-304.0	-304.0	-304.0
chrX	71377191	71377633	71377167	71377685	JUNC00003568	1	+	24	52	-304.0	-304.0	-304.0
chrX	71377821	71378234	71377746	71378305	JUNC00003569	54	+	75	71	-304.0	-304.0	-304.0
chrX	71378453	71378823	71378378	71378898	JUNC00003570	55	+	75	75	-304.0	-304.0	-304.0
chrX	71379031	71381742	71378956	71381814	JUNC00003571	59	+	75	72	-304.0	-304.0	-304.0
chrX	71381919	71382535	71381847	71382606	JUNC00003572	48	+	72	71	-304.0	-304.0	-304.0
chrX	71382663	71382760	71382588	71382833	JUNC00003573	49	+	75	73	-304.0	-304.0	-304.0
chrX	71382868	71382990	71382793	71383065	JUNC00003574	64	+	75	75	-304.0	-304.0	-304.0
chrX	71383164	71383961	71383091	71384036	JUNC00003575	71	+	73	75	-304.0	-304.0	-304.0
chrX	71384135	71384944	71384061	71385019	JUNC00003576	55	+	74	75	-304.0	-304.0	-304.0
chrX	71385049	71387260	71384974	71387335	JUNC00003577	69	+	75	75	-304.0	-304.0	-304.0
chrX	71386545	71428096	71386509	71428136	JUNC00003578	1	-	36	40	-304.0	-304.0	-304.0
chrX	71387461	71388236	71387386	71388309	JUNC00003579	48	+	75	73	-304.0	-304.0	-304.0
chrX	71388378	71388737	71388304	71388812	JUNC00003580	40	+	74	75	-304.0	-304.0	-304.0
chrX	71388381	71388737	71388322	71388754	JUNC00003581	1	+	59	17	-304.0	-304.0	-304.0
chrX	71388868	71389584	71388793	71389656	JUNC00003582	42	+	75	72	-304.0	-304.0	-304.0
chrX	71389665	71392568	71389593	71392642	JUNC00003583	46	+	72	74	-304.0	-304.0	-304.0
chrX	71392718	71392874	71392646	71392948	JUNC00003584	58	+	72	74	-304.0	-304.0	-304.0
chrX	71392994	71393300	71392921	71393375	JUNC00003585	57	+	73	75	-304.0	-304.0	-304.0
chrX	71393476	71394066	71393404	71394141	JUNC00003586	68	+	72	75	-304.0	-304.0	-304.0
chrX	71394245	71397252	71394171	71397326	JUNC00003587	81	+	74	74	-304.0	-304.0	-304.0
chrX	71394245	71397255	71394195	71397330	JUNC00003588	5	+	50	75	-304.0	-304.0	-304.0
chrX	71397466	71398571	71397391	71398642	JUNC00003589	78	+	75	71	-304.0	-304.0	-304.0
chrX	71398737	71400530	71398689	71400558	JUNC00003591	1	+	48	28	-304.0	-304.0	-304.0
chrX	71398737	71401527	71398662	71401602	JUNC00003590	94	+	75	75	-304.0	-304.0	-304.0
chrX	71401739	71406637	71401665	71406712	JUNC00003592	52	+	74	75	-304.0	-304.0	-304.0
chrX	71406746	71407573	71406673	71407644	JUNC00003593	51	+	73	71	-304.0	-304.0	-304.0
chrX	71407672	71407973	71407598	71408044	JUNC00003594	92	+	74	71	-304.0	-304.0	-304.0
chrX	71408151	71421308	71408076	71421376	JUNC00003595	53	+	75	68	-304.0	-304.0	-304.0
chrX	71421376	71423116	71421308	71423189	JUNC00003596	74	+	68	73	-304.0	-304.0	-304.0
chrX	71423239	71423973	71423168	71424047	JUNC00003597	44	+	71	74	-304.0	-304.0	-304.0
chrX	71423264	71423973	71423190	71423975	JUNC00003598	1	+	74	2	-304.0	-304.0	-304.0
chrX	71424066	71424153	71423993	71424228	JUNC00003599	70	+	73	75	-304.0	-304.0	-304.0
chrX	71424238	71454169	71424165	71454237	JUNC00003600	56	+	73	68	-304.0	-304.0	-304.0
chrX	71441721	71454169	71441720	71454237	JUNC00003602	2	+	1	68	-304.0	-304.0	-304.0
chrX	71454237	71454740	71454168	71454812	JUNC00003601	79	+	69	72	-304.0	-304.0	-304.0
chrX	71454857	71458240	71454783	71458314	JUNC00003603	71	+	74	74	-304.0	-304.0	-304.0
chrX	71458357	71459149	71458355	71459222	JUNC00003606	1	+	2	73	-304.0	-304.0	-304.0
chrX	71458366	71459149	71458303	71459222	JUNC00003605	21	+	63	73	-304.0	-304.0	-304.0
chrX	71458366	71459551	71458292	71459626	JUNC00003604	85	+	74	75	-304.0	-304.0	-304.0
chrX	71459251	71459551	71459176	71459626	JUNC00003607	54	+	75	75	-304.0	-304.0	-304.0
chrX	71459708	71460625	71459634	71460698	JUNC00003608	97	+	74	73	-304.0	-304.0	-304.0
chrX	71460803	71463823	71460728	71463894	JUNC00003609	106	+	75	71	-304.0	-304.0	-304.0
chrX	71460803	71464757	71460755	71464785	JUNC00003610	1	+	48	28	-304.0	-304.0	-304.0
chrX	71463888	71464413	71463862	71464463	JUNC00003611	1	+	26	50	-304.0	-304.0	-304.0
chrX	71464094	71464413	71464069	71464464	JUNC00003612	1	+	25	51	-304.0	-304.0	-304.0
chrX	71472686	71576286	71472657	71576331	JUNC00003613	1	-	29	45	-304.0	-304.0	-304.0
chrX	71491900	71525277	71491852	71525328	JUNC00003614	2	+	48	51	-304.0	-304.0	-304.0
chrX	71533336	71536177	71533261	71536252	JUNC00003615	215	+	75	75	-304.0	-304.0	-304.0
chrX	71533336	71536207	71533261	71536279	JUNC00003616	19	+	75	72	-304.0	-304.0	-304.0
chrX	71536358	71537828	71536284	71537903	JUNC00003617	186	+	74	75	-304.0	-304.0	-304.0
chrX	71538072	71544566	71537997	71544640	JUNC00003618	190	+	75	74	-304.0	-304.0	-304.0
chrX	71538072	71554512	71538022	71554538	JUNC00003619	1	+	50	26	-304.0	-304.0	-304.0
chrX	71544635	71547906	71544566	71547979	JUNC00003620	102	+	69	73	-304.0	-304.0	-304.0
chrX	71545037	71547906	71544985	71547930	JUNC00003621	2	+	52	24	-304.0	-304.0	-304.0
chrX	71548023	71554512	71547948	71554587	JUNC00003622	259	+	75	75	-304.0	-304.0	-304.0
chrX	71554592	71555189	71554518	71555264	JUNC00003624	205	+	74	75	-304.0	-304.0	-304.0
chrX	71554592	71555953	71554517	71556022	JUNC00003623	50	+	75	69	-304.0	-304.0	-304.0
chrX	71554592	71556679	71554568	71556731	JUNC00003625	1	+	24	52	-304.0	-304.0	-304.0
chrX	71555385	71555953	71555311	71556027	JUNC00003626	234	+	74	74	-304.0	-304.0	-304.0
chrX	71556094	71556679	71556019	71556754	JUNC00003627	306	+	75	75	-304.0	-304.0	-304.0
chrX	71556780	71556951	71556705	71557026	JUNC00003628	228	+	75	75	-304.0	-304.0	-304.0
chrX	71557105	71557194	71557030	71557268	JUNC00003629	280	+	75	74	-304.0	-304.0	-304.0
chrX	71557296	71557492	71557221	71557567	JUNC00003630	240	+	75	75	-304.0	-304.0	-304.0
chrX	71557672	71559266	71557598	71559339	JUNC00003631	203	+	74	73	-304.0	-304.0	-304.0
chrX	71557672	71559389	71557612	71559425	JUNC00003632	4	+	60	36	-304.0	-304.0	-304.0
chrX	71559425	71559587	71559351	71559661	JUNC00003633	259	+	74	74	-304.0	-304.0	-304.0
chrX	71559677	71561774	71559602	71561849	JUNC00003634	227	+	75	75	-304.0	-304.0	-304.0
chrX	71559677	71562846	71559644	71562920	JUNC00003635	2	+	33	74	-304.0	-304.0	-304.0
chrX	71561900	71562846	71561825	71562921	JUNC00003636	174	+	75	75	-304.0	-304.0	-304.0
chrX	71563017	71563129	71562942	71563204	JUNC00003637	256	+	75	75	-304.0	-304.0	-304.0
chrX	71563017	71563328	71563000	71563403	JUNC00003638	2	+	17	75	-304.0	-304.0	-304.0
chrX	71563246	71563328	71563171	71563403	JUNC00003639	285	+	75	75	-304.0	-304.0	-304.0
chrX	71563499	71564600	71563424	71564672	JUNC00003640	287	+	75	72	-304.0	-304.0	-304.0
chrX	71564753	71567499	71564678	71567574	JUNC00003641	263	+	75	75	-304.0	-304.0	-304.0
chrX	71567752	71567992	71567677	71568067	JUNC00003642	253	+	75	75	-304.0	-304.0	-304.0
chrX	71568116	71573619	71568042	71573694	JUNC00003643	389	+	74	75	-304.0	-304.0	-304.0
chrX	71570271	71586840	71570256	71586901	JUNC00003644	1	-	15	61	-304.0	-304.0	-304.0
chrX	71572013	71577443	71571961	71577481	JUNC00003645	3	-	52	38	-304.0	-304.0	-304.0
chrX	71604676	71605662	71604617	71605729	JUNC00003646	5	+	59	67	-304.0	-304.0	-304.0
chrX	71605729	71608972	71605662	71609017	JUNC00003647	2	+	67	45	-304.0	-304.0	-304.0
chrX	71609117	71610680	71609050	71610722	JUNC00003648	2	+	67	42	-304.0	-304.0	-304.0
chrX	71610819	71612354	71610754	71612409	JUNC00003649	7	+	65	55	-304.0	-304.0	-304.0
chrX	71616507	71616844	71616434	71616919	JUNC00003650	17	-	73	75	-304.0	-304.0	-304.0
chrX	71617336	71617459	71617315	71617513	JUNC00003651	1	-	21	54	-304.0	-304.0	-304.0
chrX	71617459	71618330	71617384	71618403	JUNC00003653	19	-	75	73	-304.0	-304.0	-304.0
chrX	71617459	71618437	71617384	71618510	JUNC00003652	149	-	75	73	-304.0	-304.0	-304.0
chrX	71617703	71618330	71617675	71618378	JUNC00003655	1	-	28	48	-304.0	-304.0	-304.0
chrX	71617703	71618437	71617644	71618466	JUNC00003654	4	-	59	29	-304.0	-304.0	-304.0
chrX	71663168	71663274	71663115	71663297	JUNC00003656	1	-	53	23	-304.0	-304.0	-304.0
chrX	71697301	71700820	71697232	71700894	JUNC00003657	12	+	69	74	-304.0	-304.0	-304.0
chrX	71701043	71702671	71700982	71702729	JUNC00003658	4	+	61	58	-304.0	-304.0	-304.0
chrX	71714544	71714650	71714491	71714673	JUNC00003659	1	-	53	23	-304.0	-304.0	-304.0
chrX	71778903	71780530	71778845	71780591	JUNC00003660	4	-	58	61	-304.0	-304.0	-304.0
chrX	71780753	71784272	71780679	71784341	JUNC00003661	12	-	74	69	-304.0	-304.0	-304.0
chrX	72127710	72128163	72127655	72128184	JUNC00003662	1	-	55	21	-304.0	-304.0	-304.0
chrX	72181828	72186460	72181753	72186535	JUNC00003663	95	+	75	75	-304.0	-304.0	-304.0
chrX	72181828	72196784	72181753	72196858	JUNC00003664	79	+	75	74	-304.0	-304.0	-304.0
chrX	72196904	72197367	72196829	72197441	JUNC00003665	111	+	75	74	-304.0	-304.0	-304.0
chrX	72196904	72205312	72196868	72205352	JUNC00003667	1	+	36	40	-304.0	-304.0	-304.0
chrX	72196904	72262706	72196854	72262757	JUNC00003666	2	+	50	51	-304.0	-304.0	-304.0
chrX	72208698	72237830	72208623	72237889	JUNC00003668	4	-	75	59	-304.0	-304.0	-304.0
chrX	72208698	72238843	72208623	72238910	JUNC00003669	14	-	75	67	-304.0	-304.0	-304.0
chrX	72272772	72273231	72272697	72273306	JUNC00003670	6189	-	75	75	-304.0	-304.0	-304.0
chrX	72273357	72273803	72273334	72273878	JUNC00003673	143	+	23	75	-304.0	-304.0	-304.0
chrX	72273384	72275664	72273309	72275703	JUNC00003671	65	+	75	39	-304.0	-304.0	-304.0
chrX	72273389	72273800	72273314	72273875	JUNC00003672	7010	-	75	75	-304.0	-304.0	-304.0
chrX	72273810	72273867	72273800	72273891	JUNC00003675	1	-	10	24	-304.0	-304.0	-304.0
chrX	72273828	72273867	72273800	72273942	JUNC00003674	229	-	28	75	-304.0	-304.0	-304.0
chrX	72273867	72275052	72273799	72275127	JUNC00003676	59	-	68	75	-304.0	-304.0	-304.0
chrX	72273966	72275052	72273891	72275127	JUNC00003677	89	-	75	75	-304.0	-304.0	-304.0
chrX	72273972	72275052	72273897	72275127	JUNC00003678	7239	-	75	75	-304.0	-304.0	-304.0
chrX	72273972	72275580	72273897	72275655	JUNC00003679	204	-	75	75	-304.0	-304.0	-304.0
chrX	72274435	72275052	72274413	72275127	JUNC00003680	6	-	22	75	-304.0	-304.0	-304.0
chrX	72275150	72275543	72275075	72275618	JUNC00003681	7958	-	75	75	-304.0	-304.0	-304.0
chrX	72275174	72275543	72275103	72275618	JUNC00003683	11	-	71	75	-304.0	-304.0	-304.0
chrX	72275569	72275594	72275543	72275597	JUNC00003682	4	-	26	3	102.0	102.0	102.0
chrX	72275569	72275594	72275544	72275667	JUNC00003686	2	?	25	73	102.0	102.0	102.0
chrX	72275572	72275673	72275543	72275698	JUNC00003684	2	-	29	25	-304.0	-304.0	-304.0
chrX	72275598	72275664	72275558	72275700	JUNC00003687	1	?	40	36	-304.0	-304.0	-304.0
chrX	72275598	72275664	72275596	72275724	JUNC00003690	1	-	2	60	-304.0	-304.0	-304.0
chrX	72275610	72275679	72275543	72275724	JUNC00003685	5	-	67	45	-304.0	-304.0	-304.0
chrX	72275637	72275665	72275564	72275713	JUNC00003688	4	?	73	48	-304.0	96.0	96.0
chrX	72275665	72275689	72275628	72275724	JUNC00003691	3	-	37	35	104.0	104.0	104.0
chrX	72275724	72276156	72275649	72276231	JUNC00003689	7722	-	75	75	-304.0	-304.0	-304.0
chrX	72276234	72277192	72276159	72277264	JUNC00003692	2724	-	75	72	-304.0	-304.0	-304.0
chrX	72302244	72302809	72302217	72302860	JUNC00003693	2	-	27	51	-304.0	-304.0	-304.0
chrX	72302934	72351732	72302894	72351779	JUNC00003694	2	-	40	47	-304.0	-304.0	-304.0
chrX	72330076	72330657	72330020	72330677	JUNC00003696	1	-	56	20	-304.0	-304.0	-304.0
chrX	72330076	72330815	72330022	72330876	JUNC00003697	2	-	54	61	-304.0	-304.0	-304.0
chrX	72330076	72351732	72330001	72351806	JUNC00003695	55	-	75	74	-304.0	-304.0	-304.0
chrX	72330768	72351732	72330739	72351791	JUNC00003699	2	-	29	59	-304.0	-304.0	-304.0
chrX	72330876	72351732	72330814	72351765	JUNC00003698	5	-	62	33	-304.0	-304.0	-304.0
chrX	72351838	72462003	72351763	72462077	JUNC00003700	50	-	75	74	-304.0	-304.0	-304.0
chrX	72462098	72464558	72462023	72464633	JUNC00003701	61	-	75	75	-304.0	-304.0	-304.0
chrX	72464731	72488932	72464656	72489006	JUNC00003702	42	-	75	74	-304.0	-304.0	-304.0
chrX	72489041	72490928	72488966	72491000	JUNC00003703	54	-	75	72	-304.0	-304.0	-304.0
chrX	72491006	72495155	72490932	72495227	JUNC00003704	57	-	74	72	-304.0	-304.0	-304.0
chrX	72495268	72567888	72495195	72567963	JUNC00003705	47	-	73	75	-304.0	-304.0	-304.0
chrX	72562474	72562635	72562451	72562669	JUNC00003707	1	-	23	34	-304.0	-304.0	-304.0
chrX	72562474	72567888	72562404	72567930	JUNC00003706	5	-	70	42	-304.0	-304.0	-304.0
chrX	72562669	72566198	72562635	72566217	JUNC00003708	1	-	34	19	-304.0	-304.0	-304.0
chrX	72567796	72567888	72567738	72567963	JUNC00003709	4	-	58	75	-304.0	-304.0	-304.0
chrX	72568030	72568753	72567958	72568828	JUNC00003710	57	-	72	75	-304.0	-304.0	-304.0
chrX	72568030	72572650	72567985	72572681	JUNC00003711	1	-	45	31	-304.0	-304.0	-304.0
chrX	72568884	72572056	72568809	72572110	JUNC00003712	47	-	75	54	-304.0	-304.0	-304.0
chrX	72572109	72572650	72572055	72572722	JUNC00003713	58	-	54	72	-304.0	-304.0	-304.0
chrX	72572109	72572693	72572063	72572723	JUNC00003714	1	-	46	30	-304.0	-304.0	-304.0
chrX	72581175	72582397	72581111	72582457	JUNC00003715	7	-	64	60	-304.0	-304.0	-304.0
chrX	72582598	72584248	72582571	72584297	JUNC00003716	1	-	27	49	-304.0	-304.0	-304.0
chrX	72593274	72602157	72593204	72602217	JUNC00003717	5	-	70	60	-304.0	-304.0	-304.0
chrX	72602273	72603118	72602219	72603192	JUNC00003718	10	-	54	74	-304.0	-304.0	-304.0
chrX	72603220	72605270	72603172	72605345	JUNC00003719	6	-	48	75	-304.0	-304.0	-304.0
chrX	72605619	72609623	72605559	72609694	JUNC00003720	6	-	60	71	-304.0	-304.0	-304.0
chrX	72609703	72611027	72609639	72611071	JUNC00003721	2	-	64	44	-304.0	-304.0	-304.0
chrX	72611184	72618709	72611152	72618750	JUNC00003722	1	-	32	41	-304.0	-304.0	-304.0
chrX	72618849	72619213	72618807	72619288	JUNC00003723	3	-	42	75	-304.0	-304.0	-304.0
chrX	72619305	72620724	72619238	72620782	JUNC00003724	6	-	67	58	-304.0	-304.0	-304.0
chrX	72620901	72623108	72620828	72623181	JUNC00003725	9	-	73	73	-304.0	-304.0	-304.0
chrX	72627049	72635154	72626993	72635213	JUNC00003726	6	-	56	59	-304.0	-304.0	-304.0
chrX	72635299	72636276	72635253	72636323	JUNC00003727	2	-	46	47	-304.0	-304.0	-304.0
chrX	72636386	72644361	72636314	72644424	JUNC00003728	5	-	72	63	-304.0	-304.0	-304.0
chrX	72644496	72650389	72644432	72650438	JUNC00003729	9	-	64	49	-304.0	-304.0	-304.0
chrX	72650468	72652543	72650416	72652606	JUNC00003730	2	-	52	63	-304.0	-304.0	-304.0
chrX	72653530	72656119	72653462	72656163	JUNC00003731	3	-	68	44	-304.0	-304.0	-304.0
chrX	72656242	72657587	72656212	72657633	JUNC00003732	1	-	30	46	-304.0	-304.0	-304.0
chrX	72657641	72666150	72657621	72666225	JUNC00003733	3	-	20	75	-304.0	-304.0	-304.0
chrX	72666297	72667374	72666266	72667421	JUNC00003734	2	-	31	47	-304.0	-304.0	-304.0
chrX	72667473	72676069	72667438	72676110	JUNC00003735	1	-	35	41	-304.0	-304.0	-304.0
chrX	72684580	72695707	72684543	72695746	JUNC00003736	1	-	37	39	-304.0	-304.0	-304.0
chrX	72712937	72713802	72712879	72713826	JUNC00003737	2	-	58	24	-304.0	-304.0	-304.0
chrX	72845557	72845871	72845535	72845925	JUNC00003738	1	+	22	54	-304.0	-304.0	-304.0
chrX	72846005	72846884	72845969	72846924	JUNC00003739	1	+	36	40	-304.0	-304.0	-304.0
chrX	72873942	72874824	72873902	72874860	JUNC00003740	1	-	40	36	-304.0	-304.0	-304.0
chrX	72874958	72875272	72874904	72875294	JUNC00003741	1	-	54	22	-304.0	-304.0	-304.0
chrX	73234156	73316211	73234118	73316249	JUNC00003742	1	+	38	38	-304.0	-304.0	-304.0
chrX	73526687	73563020	73526645	73563054	JUNC00003743	1	-	42	34	-304.0	-304.0	-304.0
chrX	73563580	73577406	73563513	73577461	JUNC00003744	9	+	67	55	-304.0	-304.0	-304.0
chrX	73577461	73578703	73577406	73578752	JUNC00003746	2	+	55	49	-304.0	-304.0	-304.0
chrX	73577461	73584416	73577406	73584491	JUNC00003745	13	+	55	75	-304.0	-304.0	-304.0
chrX	73584572	73648038	73584524	73648063	JUNC00003748	1	+	48	25	-304.0	-304.0	-304.0
chrX	73584572	73679325	73584501	73679382	JUNC00003747	18	+	71	57	-304.0	-304.0	-304.0
chrX	73679382	73679653	73679325	73679724	JUNC00003749	21	+	57	71	-304.0	-304.0	-304.0
chrX	73679382	73680954	73679340	73681009	JUNC00003750	2	+	42	55	-304.0	-304.0	-304.0
chrX	73679713	73680954	73679653	73681006	JUNC00003751	9	+	60	52	-304.0	-304.0	-304.0
chrX	73829231	73831065	73829177	73831087	JUNC00003752	1	-	54	22	-304.0	-304.0	-304.0
chrX	73831274	73833237	73831207	73833299	JUNC00003753	2	-	67	62	-304.0	-304.0	-304.0
chrX	73833374	73837439	73833302	73837443	JUNC00003754	1	-	72	4	-304.0	-304.0	-304.0
chrX	73883607	73941804	73883589	73941860	JUNC00003755	1	+	18	56	-304.0	104.0	104.0
chrX	73891540	73941804	73891522	73941860	JUNC00003756	1	+	18	56	102.0	-304.0	102.0
chrX	73899729	73929177	73899692	73929216	JUNC00003757	1	+	37	39	-304.0	-304.0	-304.0
chrX	73937852	73969039	73937831	73969094	JUNC00003758	1	+	21	55	-304.0	-304.0	-304.0
chrX	73944465	73944583	73944393	73944642	JUNC00003759	9	+	72	59	-304.0	-304.0	-304.0
chrX	73944465	73962730	73944443	73962784	JUNC00003762	1	+	22	54	-304.0	-304.0	-304.0
chrX	73944465	73994839	73944408	73994914	JUNC00003760	7	+	57	75	-304.0	-304.0	-304.0
chrX	73944465	73998767	73944429	73998828	JUNC00003761	4	+	36	61	-304.0	-304.0	-304.0
chrX	73944662	73992431	73944602	73992447	JUNC00003763	1	+	60	16	-304.0	-304.0	-304.0
chrX	73944662	73994839	73944609	73994914	JUNC00003764	6	+	53	75	-304.0	-304.0	-304.0
chrX	73944662	73998767	73944624	73998805	JUNC00003765	1	+	38	38	-304.0	-304.0	-304.0
chrX	73962801	73998767	73962784	73998826	JUNC00003766	1	+	17	59	-304.0	-304.0	-304.0
chrX	73994961	73998767	73994893	73998839	JUNC00003767	9	+	68	72	-304.0	-304.0	-304.0
chrX	73994961	74004269	73994919	74004303	JUNC00003768	1	+	42	34	-304.0	-304.0	-304.0
chrX	73997166	73998767	73997145	73998822	JUNC00003769	1	+	21	55	-304.0	-304.0	-304.0
chrX	73998844	73998953	73998770	73999023	JUNC00003770	11	+	74	70	-304.0	-304.0	-304.0
chrX	73998844	74004269	73998802	74004311	JUNC00003771	2	+	42	42	-304.0	-304.0	-304.0
chrX	74000496	74004269	74000429	74004344	JUNC00003772	12	+	67	75	-304.0	-304.0	-304.0
chrX	74062148	74069168	74062096	74069192	JUNC00003773	1	+	52	24	-304.0	-304.0	-304.0
chrX	74203953	74274341	74203896	74274360	JUNC00003774	1	-	57	19	-304.0	-304.0	-304.0
chrX	74247424	74274341	74247380	74274373	JUNC00003775	1	-	44	32	-304.0	-304.0	-304.0
chrX	74247923	74274341	74247868	74274399	JUNC00003776	3	-	55	58	-304.0	-304.0	-304.0
chrX	74274410	74280393	74274352	74280446	JUNC00003777	3	-	58	53	-304.0	-304.0	-304.0
chrX	74280494	74280930	74280419	74281004	JUNC00003778	7	-	75	74	-304.0	-304.0	-304.0
chrX	74281085	74281701	74281020	74281769	JUNC00003779	6	-	65	68	-304.0	-304.0	-304.0
chrX	74281848	74292168	74281790	74292205	JUNC00003780	2	-	58	37	-304.0	-304.0	-304.0
chrX	74281848	74292426	74281808	74292465	JUNC00003781	2	-	40	39	-304.0	-304.0	-304.0
chrX	74289386	74292168	74289369	74292226	JUNC00003782	1	-	17	58	-304.0	-304.0	-304.0
chrX	74290430	74292168	74290392	74292197	JUNC00003783	1	-	38	29	-304.0	-304.0	-304.0
chrX	74319332	74347298	74319308	74347352	JUNC00003784	8	+	24	54	-304.0	-304.0	-304.0
chrX	74340848	74347298	74340813	74347339	JUNC00003785	1	+	35	41	-304.0	-304.0	-304.0
chrX	74345160	74347298	74345139	74347353	JUNC00003786	1	+	21	55	-304.0	-304.0	-304.0
chrX	74353295	74441294	74353252	74441327	JUNC00003787	1	+	43	33	-304.0	-304.0	-304.0
chrX	74409739	74409793	74409687	74409817	JUNC00003788	1	?	52	24	-304.0	-304.0	-304.0
chrX	74593061	74594305	74592986	74594380	JUNC00003789	34	-	75	75	-304.0	-304.0	-304.0
chrX	74594389	74595808	74594316	74595883	JUNC00003790	42	-	73	75	-304.0	-304.0	-304.0
chrX	74596000	74612581	74595935	74612643	JUNC00003792	6	-	65	62	-304.0	-304.0	-304.0
chrX	74596000	74614421	74595931	74614494	JUNC00003791	18	-	69	73	-304.0	-304.0	-304.0
chrX	74612643	74614421	74612581	74614437	JUNC00003793	2	-	62	16	-304.0	-304.0	-304.0
chrX	74744477	74745571	74744423	74745593	JUNC00003794	1	-	54	22	-304.0	-304.0	-304.0
chrX	74745697	74924882	74745655	74924916	JUNC00003795	1	-	42	34	-304.0	-304.0	-304.0
chrX	75053585	75060222	75053510	75060297	JUNC00003796	87	-	75	75	-304.0	-304.0	-304.0
chrX	75060330	75062327	75060255	75062400	JUNC00003797	86	-	75	73	-304.0	-304.0	-304.0
chrX	75062431	75065069	75062356	75065144	JUNC00003798	109	-	75	75	-304.0	-304.0	-304.0
chrX	75063159	75065069	75063141	75065144	JUNC00003799	3	-	18	75	-304.0	-304.0	-304.0
chrX	75065241	75069006	75065166	75069081	JUNC00003800	93	-	75	75	-304.0	-304.0	-304.0
chrX	75069136	75069290	75069061	75069365	JUNC00003801	106	-	75	75	-304.0	-304.0	-304.0
chrX	75069454	75070364	75069380	75070439	JUNC00003802	84	-	74	75	-304.0	-304.0	-304.0
chrX	75070522	75071508	75070448	75071583	JUNC00003803	63	-	74	75	-304.0	-304.0	-304.0
chrX	75070522	75073732	75070477	75073776	JUNC00003804	3	-	45	44	-304.0	-304.0	-304.0
chrX	75071683	75073688	75071608	75073760	JUNC00003806	51	-	75	72	-304.0	-304.0	-304.0
chrX	75073776	75073867	75073703	75073941	JUNC00003805	102	-	73	74	-304.0	-304.0	-304.0
chrX	75073956	75075361	75073881	75075435	JUNC00003807	118	-	75	74	-304.0	-304.0	-304.0
chrX	75075630	75076521	75075556	75076595	JUNC00003808	83	-	74	74	-304.0	-304.0	-304.0
chrX	75076654	75098941	75076580	75099014	JUNC00003809	100	-	74	73	-304.0	-304.0	-304.0
chrX	75099061	75112885	75098986	75112959	JUNC00003810	70	-	75	74	-304.0	-304.0	-304.0
chrX	75112972	75114753	75112898	75114827	JUNC00003811	88	-	74	74	-304.0	-304.0	-304.0
chrX	75114831	75156104	75114758	75156179	JUNC00003812	37	-	73	75	-304.0	-304.0	-304.0
chrX	75114834	75156104	75114759	75156179	JUNC00003813	41	-	75	75	-304.0	-304.0	-304.0
chrX	75274398	75293471	75274367	75293516	JUNC00003814	2	+	31	45	-304.0	-304.0	-304.0
chrX	75274640	75293471	75274571	75293514	JUNC00003816	52	+	69	43	-304.0	-304.0	-304.0
chrX	75274758	75285422	75274740	75285480	JUNC00003819	1	+	18	58	-304.0	-304.0	-304.0
chrX	75274758	75293471	75274693	75293514	JUNC00003818	3	+	65	43	-304.0	-304.0	-304.0
chrX	75293514	75294562	75293471	75294619	JUNC00003815	7	+	43	57	-304.0	-304.0	-304.0
chrX	75293514	75296341	75293471	75296411	JUNC00003817	40	+	43	70	-304.0	-304.0	-304.0
chrX	75294620	75296341	75294562	75296409	JUNC00003821	8	+	58	68	-304.0	-304.0	-304.0
chrX	75296411	75297490	75296340	75297555	JUNC00003820	72	+	71	65	-304.0	-304.0	-304.0
chrX	75297553	75299734	75297486	75299808	JUNC00003822	80	+	67	74	-304.0	-304.0	-304.0
chrX	75299896	75300866	75299821	75300940	JUNC00003823	47	+	75	74	-304.0	-304.0	-304.0
chrX	75300965	75303404	75300891	75303479	JUNC00003824	36	+	74	75	-304.0	-304.0	-304.0
chrX	75301011	75303404	75300982	75303479	JUNC00003826	2	+	29	75	-304.0	-304.0	-304.0
chrX	75301015	75303404	75300940	75303479	JUNC00003825	7	+	75	75	-304.0	-304.0	-304.0
chrX	76173168	76173584	76173093	76173650	JUNC00003827	92	+	75	66	-304.0	-304.0	-304.0
chrX	76173168	76174889	76173152	76174949	JUNC00003829	1	+	16	60	-304.0	-304.0	-304.0
chrX	76173191	76173584	76173146	76173615	JUNC00003828	1	+	45	31	-304.0	-304.0	-304.0
chrX	76173650	76174889	76173584	76174949	JUNC00003830	113	+	66	60	-304.0	-304.0	-304.0
chrX	76174949	76175472	76174889	76175547	JUNC00003831	102	+	60	75	-304.0	-304.0	-304.0
chrX	76175613	76176880	76175541	76176950	JUNC00003832	117	+	72	70	-304.0	-304.0	-304.0
chrX	76175613	76177615	76175545	76177684	JUNC00003833	9	+	68	69	-304.0	-304.0	-304.0
chrX	76176992	76177615	76176917	76177690	JUNC00003834	119	+	75	75	-304.0	-304.0	-304.0
chrX	76176992	76177688	76176965	76177740	JUNC00003835	2	+	27	52	-304.0	-304.0	-304.0
chrX	76177802	76177850	76177735	76177899	JUNC00003836	2	?	67	49	-304.0	-304.0	-304.0
chrX	77508629	77520787	77508555	77520862	JUNC00003837	78	-	74	75	-304.0	-304.0	-304.0
chrX	77520916	77521402	77520844	77521477	JUNC00003838	63	-	72	75	-304.0	-304.0	-304.0
chrX	77520916	77521441	77520877	77521478	JUNC00003839	1	-	39	37	-304.0	-304.0	-304.0
chrX	77521498	77522262	77521423	77522337	JUNC00003840	63	-	75	75	-304.0	-304.0	-304.0
chrX	77522388	77523251	77522315	77523326	JUNC00003841	65	-	73	75	-304.0	-304.0	-304.0
chrX	77523401	77557450	77523326	77557519	JUNC00003842	80	-	75	69	-304.0	-304.0	-304.0
chrX	77557645	77558668	77557571	77558742	JUNC00003843	74	-	74	74	-304.0	-304.0	-304.0
chrX	77558846	77574249	77558778	77574324	JUNC00003844	43	-	68	75	-304.0	-304.0	-304.0
chrX	77574358	77575553	77574287	77575594	JUNC00003846	2	-	71	41	-304.0	-304.0	-304.0
chrX	77574358	77589833	77574284	77589900	JUNC00003845	48	-	74	67	-304.0	-304.0	-304.0
chrX	77589940	77593695	77589865	77593769	JUNC00003847	46	-	75	74	-304.0	-304.0	-304.0
chrX	77593783	77599410	77593749	77599482	JUNC00003848	2	-	34	72	-304.0	-304.0	-304.0
chrX	77593849	77595711	77593799	77595759	JUNC00003850	3	-	50	48	-304.0	-304.0	-304.0
chrX	77593849	77599410	77593778	77599485	JUNC00003849	58	-	71	75	-304.0	-304.0	-304.0
chrX	77599580	77599731	77599506	77599800	JUNC00003851	41	-	74	69	-304.0	-304.0	-304.0
chrX	77599820	77600433	77599747	77600504	JUNC00003852	39	-	73	71	-304.0	-304.0	-304.0
chrX	77600564	77616612	77600489	77616685	JUNC00003853	64	-	75	73	-304.0	-304.0	-304.0
chrX	77616511	77616612	77616492	77616669	JUNC00003854	1	-	19	57	-304.0	-304.0	-304.0
chrX	77616730	77618805	77616656	77618878	JUNC00003855	68	-	74	73	-304.0	-304.0	-304.0
chrX	77618981	77620394	77618906	77620466	JUNC00003856	39	-	75	72	-304.0	-304.0	-304.0
chrX	77620532	77633206	77620459	77633281	JUNC00003857	47	-	73	75	-304.0	-304.0	-304.0
chrX	77633384	77633565	77633310	77633640	JUNC00003858	55	-	74	75	-304.0	-304.0	-304.0
chrX	77633712	77634593	77633638	77634666	JUNC00003859	48	-	74	73	-304.0	-304.0	-304.0
chrX	77634518	77634593	77634473	77634624	JUNC00003860	1	-	45	31	-304.0	-304.0	-304.0
chrX	77634703	77635914	77634629	77635987	JUNC00003861	33	-	74	73	-304.0	-304.0	-304.0
chrX	77636056	77652113	77635983	77652188	JUNC00003862	40	-	73	75	-304.0	-304.0	-304.0
chrX	77641346	77670916	77641307	77670953	JUNC00003863	2	+	39	37	-304.0	-304.0	-304.0
chrX	77652353	77654097	77652281	77654172	JUNC00003864	45	-	72	75	-304.0	-304.0	-304.0
chrX	77654200	77656559	77654129	77656633	JUNC00003865	70	-	71	74	-304.0	-304.0	-304.0
chrX	77656653	77663381	77656578	77663455	JUNC00003866	67	-	75	74	-304.0	-304.0	-304.0
chrX	77663558	77664644	77663483	77664719	JUNC00003867	57	-	75	75	-304.0	-304.0	-304.0
chrX	77664778	77676225	77664707	77676299	JUNC00003868	54	-	71	74	-304.0	-304.0	-304.0
chrX	77676298	77681519	77676225	77681594	JUNC00003869	72	-	73	75	-304.0	-304.0	-304.0
chrX	77683451	77683538	77683394	77683612	JUNC00003870	8	-	57	74	-304.0	-304.0	-304.0
chrX	77684593	77684938	77684528	77685007	JUNC00003871	65	-	65	69	-304.0	-304.0	-304.0
chrX	77685006	77688817	77684937	77688891	JUNC00003872	52	-	69	74	-304.0	-304.0	-304.0
chrX	77688924	77693823	77688849	77693885	JUNC00003873	9	-	75	62	-304.0	-304.0	-304.0
chrX	77688924	77696576	77688851	77696649	JUNC00003874	7	-	73	73	-304.0	-304.0	-304.0
chrX	77688927	77693823	77688857	77693897	JUNC00003875	21	-	70	74	-304.0	-304.0	-304.0
chrX	77688927	77696576	77688880	77696642	JUNC00003876	6	-	47	66	-304.0	-304.0	-304.0
chrX	77693937	77696576	77693866	77696647	JUNC00003877	25	-	71	71	-304.0	-304.0	-304.0
chrX	77696704	77697582	77696630	77697637	JUNC00003878	47	-	74	55	-304.0	-304.0	-304.0
chrX	77697635	77698573	77697581	77698630	JUNC00003879	43	-	54	57	-304.0	-304.0	-304.0
chrX	77698629	77717130	77698573	77717204	JUNC00003880	40	-	56	74	-304.0	-304.0	-304.0
chrX	77698629	77785981	77698589	77786015	JUNC00003881	1	-	40	34	-304.0	-304.0	-304.0
chrX	77717243	77785844	77717168	77785887	JUNC00003883	5	-	75	43	-304.0	-304.0	-304.0
chrX	77717243	77785981	77717168	77786056	JUNC00003882	43	-	75	75	-304.0	-304.0	-304.0
chrX	77763701	77827672	77763657	77827703	JUNC00003884	1	-	44	31	136.0	132.0	136.0
chrX	77781276	77785844	77781250	77785894	JUNC00003885	1	-	26	50	-304.0	-304.0	-304.0
chrX	77826809	77829030	77826765	77829102	JUNC00003886	3	-	44	72	-304.0	-304.0	-304.0
chrX	77829235	77830804	77829160	77830878	JUNC00003887	228	-	75	74	-304.0	-304.0	-304.0
chrX	77829235	77841245	77829206	77841292	JUNC00003888	1	-	29	47	-304.0	-304.0	-304.0
chrX	77830895	77841245	77830820	77841319	JUNC00003889	179	-	75	74	-304.0	-304.0	-304.0
chrX	77830895	77855500	77830861	77855538	JUNC00003890	1	-	34	38	-304.0	-304.0	-304.0
chrX	77841320	77843387	77841263	77843405	JUNC00003892	1	-	57	18	-304.0	-304.0	-304.0
chrX	77841320	77848888	77841265	77848909	JUNC00003893	1	-	55	21	-304.0	-304.0	-304.0
chrX	77841320	77853900	77841245	77853965	JUNC00003891	184	-	75	65	-304.0	-304.0	-304.0
chrX	77841320	77855500	77841287	77855543	JUNC00003894	1	-	33	43	-304.0	-304.0	-304.0
chrX	77853964	77855500	77853900	77855575	JUNC00003895	201	-	64	75	-304.0	-304.0	-304.0
chrX	77855590	77856732	77855515	77856807	JUNC00003896	145	-	75	75	-304.0	-304.0	-304.0
chrX	77855590	77870807	77855539	77870831	JUNC00003897	1	-	51	24	-304.0	-304.0	-304.0
chrX	77856873	77857356	77856800	77857429	JUNC00003898	191	-	73	73	-304.0	-304.0	-304.0
chrX	77857497	77870807	77857422	77870880	JUNC00003899	182	-	75	73	-304.0	-304.0	-304.0
chrX	77870925	77875427	77870850	77875501	JUNC00003900	247	-	75	74	-304.0	-304.0	-304.0
chrX	77875597	77883932	77875523	77883990	JUNC00003902	3	-	74	58	-304.0	-304.0	-304.0
chrX	77875597	77893168	77875557	77893204	JUNC00003903	1	-	40	36	-304.0	-304.0	-304.0
chrX	77875597	77895308	77875522	77895383	JUNC00003901	176	-	75	75	-304.0	-304.0	-304.0
chrX	77884189	77895308	77884173	77895368	JUNC00003904	1	-	16	60	-304.0	-304.0	-304.0
chrX	77899593	77901920	77899551	77901991	JUNC00003908	5	+	42	71	-304.0	-304.0	-304.0
chrX	77899593	77902642	77899518	77902717	JUNC00003905	1572	+	75	75	-304.0	-304.0	-304.0
chrX	77899593	77902649	77899540	77902672	JUNC00003907	1	+	53	23	-304.0	-304.0	-304.0
chrX	77899593	77905183	77899531	77905201	JUNC00003906	2	+	62	18	-304.0	-304.0	-304.0
chrX	77901867	77902642	77901845	77902717	JUNC00003910	19	+	22	75	-304.0	-304.0	-304.0
chrX	77902015	77902642	77901952	77902717	JUNC00003911	11	+	63	75	-304.0	-304.0	-304.0
chrX	77902714	77905183	77902639	77905258	JUNC00003909	91	+	75	75	-304.0	-304.0	-304.0
chrX	77902767	77905183	77902692	77905258	JUNC00003912	1317	+	75	75	-304.0	-304.0	-304.0
chrX	77910835	77922998	77910770	77923042	JUNC00003915	9	+	65	44	-304.0	-304.0	-304.0
chrX	77910835	77962622	77910767	77962697	JUNC00003914	13	+	68	75	-304.0	-304.0	-304.0
chrX	77910835	77971620	77910764	77971693	JUNC00003913	27	+	71	73	-304.0	-304.0	-304.0
chrX	77962814	77971620	77962770	77971687	JUNC00003916	4	+	44	67	-304.0	-304.0	-304.0
chrX	77969041	77969214	77969019	77969268	JUNC00003917	1	?	22	54	-304.0	-304.0	-304.0
chrX	77971761	77975510	77971724	77975549	JUNC00003920	1	+	37	39	-304.0	-304.0	-304.0
chrX	77971761	77988241	77971690	77988314	JUNC00003918	28	+	71	73	-304.0	-304.0	-304.0
chrX	77971761	78031399	77971696	78031474	JUNC00003919	4	+	65	75	-304.0	-304.0	-304.0
chrX	77974808	77975510	77974778	77975581	JUNC00003921	2	+	30	71	-304.0	-304.0	-304.0
chrX	77988731	77989232	77988656	77989306	JUNC00003922	34	+	75	74	-304.0	-304.0	-304.0
chrX	77989958	77998477	77989893	77998545	JUNC00003923	14	+	65	68	-304.0	-304.0	-304.0
chrX	77989958	77998561	77989900	77998579	JUNC00003924	1	+	58	18	-304.0	-304.0	-304.0
chrX	77998684	78003072	77998609	78003147	JUNC00003925	26	+	75	75	-304.0	-304.0	-304.0
chrX	78003236	78009101	78003161	78009163	JUNC00003926	30	+	75	62	-304.0	-304.0	-304.0
chrX	78009263	78011175	78009188	78011249	JUNC00003927	37	+	75	74	-304.0	-304.0	-304.0
chrX	78011252	78011448	78011181	78011511	JUNC00003928	27	+	71	63	-304.0	-304.0	-304.0
chrX	78013112	78014661	78013038	78014736	JUNC00003929	35	+	74	75	-304.0	-304.0	-304.0
chrX	78014753	78015753	78014681	78015827	JUNC00003930	35	+	72	74	-304.0	-304.0	-304.0
chrX	78015881	78020243	78015807	78020318	JUNC00003931	35	+	74	75	-304.0	-304.0	-304.0
chrX	78020398	78020944	78020323	78021017	JUNC00003932	44	+	75	73	-304.0	-304.0	-304.0
chrX	78020398	78031399	78020328	78031474	JUNC00003933	4	+	70	75	-304.0	-304.0	-304.0
chrX	78021079	78029249	78021004	78029322	JUNC00003934	38	+	75	73	-304.0	-304.0	-304.0
chrX	78029444	78031399	78029374	78031474	JUNC00003935	28	+	70	75	-304.0	-304.0	-304.0
chrX	78031582	78033604	78031507	78033679	JUNC00003936	53	+	75	75	-304.0	-304.0	-304.0
chrX	78031582	78038835	78031550	78038879	JUNC00003937	1	+	32	44	-304.0	-304.0	-304.0
chrX	78033821	78038835	78033747	78038910	JUNC00003938	49	+	74	75	-304.0	-304.0	-304.0
chrX	78038982	78040590	78038909	78040665	JUNC00003939	40	+	73	75	-304.0	-304.0	-304.0
chrX	78040733	78042584	78040658	78042655	JUNC00003940	29	+	75	71	-304.0	-304.0	-304.0
chrX	78042788	78043316	78042715	78043380	JUNC00003941	54	+	73	64	-304.0	-304.0	-304.0
chrX	78043434	78045469	78043364	78045544	JUNC00003942	22	+	70	75	-304.0	-304.0	-304.0
chrX	78045572	78046293	78045499	78046364	JUNC00003943	35	+	73	71	-304.0	-304.0	-304.0
chrX	78060233	78062886	78060160	78062951	JUNC00003944	7	-	73	65	-304.0	-304.0	-304.0
chrX	78063375	78063948	78063321	78063970	JUNC00003945	1	-	54	22	-304.0	-304.0	-304.0
chrX	78065272	78088865	78065220	78088889	JUNC00003946	1	+	52	24	-304.0	-304.0	-304.0
chrX	78065272	78096652	78065234	78096711	JUNC00003947	2	+	38	59	-304.0	-304.0	-304.0
chrX	78088987	78096652	78088934	78096687	JUNC00003948	2	+	53	35	-304.0	-304.0	-304.0
chrX	78104405	78106813	78104332	78106857	JUNC00003950	8	+	73	44	-304.0	-304.0	-304.0
chrX	78104405	78109866	78104330	78109919	JUNC00003949	5182	+	75	53	-304.0	-304.0	-304.0
chrX	78105066	78109866	78105010	78109917	JUNC00003952	9	+	56	51	-304.0	-304.0	-304.0
chrX	78105340	78109866	78105282	78109917	JUNC00003953	17	+	58	51	-304.0	-304.0	-304.0
chrX	78107085	78109866	78107034	78109917	JUNC00003954	13	+	51	51	-304.0	-304.0	-304.0
chrX	78109917	78113743	78109864	78113818	JUNC00003951	4542	+	53	75	-304.0	-304.0	-304.0
chrX	78113794	78114015	78113743	78114090	JUNC00003955	224	+	51	75	-304.0	-304.0	-304.0
chrX	78113899	78114015	78113824	78114090	JUNC00003956	4027	+	75	75	-304.0	-304.0	-304.0
chrX	78113899	78114034	78113824	78114072	JUNC00003957	38	+	75	38	-304.0	-304.0	-304.0
chrX	78114160	78117311	78114085	78117386	JUNC00003958	4309	+	75	75	-304.0	-304.0	-304.0
chrX	78117415	78118050	78117340	78118125	JUNC00003959	3712	+	75	75	-304.0	-304.0	-304.0
chrX	78117415	78122834	78117355	78122909	JUNC00003960	19	+	60	75	-304.0	-304.0	-304.0
chrX	78118170	78118867	78118096	78118926	JUNC00003962	3	+	74	59	-304.0	-304.0	-304.0
chrX	78118170	78122834	78118095	78122909	JUNC00003961	5121	+	75	75	-304.0	-304.0	-304.0
chrX	78119799	78122834	78119782	78122893	JUNC00003963	1	+	17	59	-304.0	-304.0	-304.0
chrX	78122949	78123194	78122874	78123269	JUNC00003964	5249	+	75	75	-304.0	-304.0	-304.0
chrX	78123374	78124873	78123299	78124948	JUNC00003965	3985	+	75	75	-304.0	-304.0	-304.0
chrX	78123374	78125326	78123355	78125382	JUNC00003966	1	+	19	56	-304.0	-304.0	-304.0
chrX	78125051	78125326	78124976	78125401	JUNC00003967	8228	+	75	75	-304.0	-304.0	-304.0
chrX	78125051	78125335	78124997	78125410	JUNC00003968	18	+	54	75	-304.0	-304.0	-304.0
chrX	78125425	78125789	78125350	78125864	JUNC00003969	4920	+	75	75	-304.0	-304.0	-304.0
chrX	78129727	78131613	78129683	78131688	JUNC00003970	2	-	44	75	-304.0	-304.0	-304.0
chrX	78131773	78133337	78131698	78133412	JUNC00003971	48	-	75	75	-304.0	-304.0	-304.0
chrX	78133448	78136914	78133374	78136989	JUNC00003972	42	-	74	75	-304.0	-304.0	-304.0
chrX	78136990	78137748	78136917	78137823	JUNC00003973	41	-	73	75	-304.0	-304.0	-304.0
chrX	78137883	78137961	78137809	78138030	JUNC00003974	29	-	74	69	-304.0	-304.0	-304.0
chrX	78138098	78138842	78138026	78138917	JUNC00003975	35	-	72	75	-304.0	-304.0	-304.0
chrX	78138924	78139560	78138852	78139630	JUNC00003976	26	-	72	70	-304.0	-304.0	-304.0
chrX	78273773	78283453	78273698	78283523	JUNC00003977	29	-	75	70	-304.0	-304.0	-304.0
chrX	78283540	78327304	78283465	78327376	JUNC00003978	34	-	75	72	-304.0	-304.0	-304.0
chrX	78945222	78945345	78945183	78945382	JUNC00003979	1	+	39	37	-304.0	-304.0	-304.0
chrX	78945495	78947814	78945420	78947865	JUNC00003980	50	+	75	51	-304.0	-304.0	-304.0
chrX	78945495	78952192	78945420	78952267	JUNC00003982	52	+	75	75	-304.0	-304.0	-304.0
chrX	78945495	78952223	78945421	78952298	JUNC00003983	5	+	74	75	-304.0	-304.0	-304.0
chrX	78945495	78960507	78945420	78960582	JUNC00003981	107	+	75	75	-304.0	-304.0	-304.0
chrX	78947863	78952192	78947814	78952267	JUNC00003985	29	+	49	75	-304.0	-304.0	-304.0
chrX	78947863	78960507	78947814	78960577	JUNC00003984	20	+	49	70	-304.0	-304.0	-304.0
chrX	78952335	78958268	78952309	78958318	JUNC00003987	1	+	26	50	-304.0	-304.0	-304.0
chrX	78952335	78960507	78952262	78960582	JUNC00003986	69	+	73	75	-304.0	-304.0	-304.0
chrX	78952567	78960507	78952517	78960533	JUNC00003988	1	+	50	26	-304.0	-304.0	-304.0
chrX	79145217	79156821	79145142	79156895	JUNC00003989	34	+	75	74	-304.0	-304.0	-304.0
chrX	79145217	79170451	79145177	79170487	JUNC00003990	1	+	40	36	-304.0	-304.0	-304.0
chrX	79154803	79156821	79154774	79156868	JUNC00003991	1	+	29	47	-304.0	-304.0	-304.0
chrX	79156918	79170451	79156848	79170524	JUNC00003992	37	+	70	73	-304.0	-304.0	-304.0
chrX	79156918	79171474	79156848	79171495	JUNC00003993	2	+	70	21	-304.0	-304.0	-304.0
chrX	79189886	79244358	79189835	79244383	JUNC00003994	1	+	51	25	-304.0	-304.0	-304.0
chrX	79189886	79366866	79189836	79366892	JUNC00003995	1	+	50	26	-304.0	-304.0	-304.0
chrX	79225904	79350677	79225867	79350716	JUNC00003996	1	+	37	39	-304.0	-304.0	-304.0
chrX	79324852	79345325	79324802	79345351	JUNC00003997	1	+	50	26	-304.0	-304.0	-304.0
chrX	79360844	79361064	79360786	79361082	JUNC00003998	1	-	58	18	-304.0	-304.0	-304.0
chrX	79361177	79361328	79361102	79361402	JUNC00003999	271	-	75	74	-304.0	-304.0	-304.0
chrX	79361479	79362580	79361405	79362655	JUNC00004000	212	-	74	75	-304.0	-304.0	-304.0
chrX	79362691	79362941	79362616	79363016	JUNC00004001	308	-	75	75	-304.0	-304.0	-304.0
chrX	79363139	79363422	79363064	79363497	JUNC00004002	236	-	75	75	-304.0	-304.0	-304.0
chrX	79363139	79367104	79363065	79367177	JUNC00004003	24	-	74	73	-304.0	-304.0	-304.0
chrX	79363469	79367104	79363422	79367178	JUNC00004004	9	-	47	74	-304.0	-304.0	-304.0
chrX	79363554	79367104	79363480	79367178	JUNC00004005	191	-	74	74	-304.0	-304.0	-304.0
chrX	79366980	79379985	79366911	79380022	JUNC00004006	2	+	69	37	-304.0	-304.0	-304.0
chrX	79366980	79397833	79366941	79397870	JUNC00004007	1	+	39	37	-304.0	-304.0	-304.0
chrX	79367273	79367546	79367201	79367569	JUNC00004008	4	-	72	23	-304.0	-304.0	-304.0
chrX	79451545	79452058	79451519	79452108	JUNC00004009	1	+	26	50	-304.0	-304.0	-304.0
chrX	79502254	79505746	79502199	79505767	JUNC00004010	1	-	55	21	-304.0	-304.0	-304.0
chrX	80677363	80681340	80677291	80681412	JUNC00004011	35	-	72	72	-304.0	-304.0	-304.0
chrX	80681493	80681996	80681422	80682059	JUNC00004012	3	-	71	63	-304.0	-304.0	-304.0
chrX	80681499	80681996	80681424	80682071	JUNC00004013	34	-	75	75	-304.0	-304.0	-304.0
chrX	80682094	80682464	80682021	80682537	JUNC00004014	37	-	73	73	-304.0	-304.0	-304.0
chrX	80682628	80684009	80682556	80684066	JUNC00004015	16	-	72	57	-304.0	-304.0	-304.0
chrX	80684162	80685461	80684089	80685532	JUNC00004016	30	-	73	71	-304.0	-304.0	-304.0
chrX	80685536	80686862	80685472	80686937	JUNC00004017	25	-	64	75	-304.0	-304.0	-304.0
chrX	80687003	80688068	80686932	80688126	JUNC00004018	31	-	71	58	-304.0	-304.0	-304.0
chrX	80688125	80689767	80688068	80689842	JUNC00004019	24	-	57	75	-304.0	-304.0	-304.0
chrX	80689846	80689966	80689783	80690041	JUNC00004020	22	-	63	75	-304.0	-304.0	-304.0
chrX	80690092	80691052	80690017	80691127	JUNC00004021	39	-	75	75	-304.0	-304.0	-304.0
chrX	80691173	80691822	80691099	80691891	JUNC00004022	38	-	74	69	-304.0	-304.0	-304.0
chrX	80691978	80692088	80691906	80692150	JUNC00004023	27	-	72	62	-304.0	-304.0	-304.0
chrX	80692150	80692939	80692088	80693013	JUNC00004024	29	-	62	74	-304.0	-304.0	-304.0
chrX	80693051	80695907	80692981	80695971	JUNC00004025	17	-	70	64	-304.0	-304.0	-304.0
chrX	80695990	80696738	80695924	80696813	JUNC00004026	17	-	66	75	-304.0	-304.0	-304.0
chrX	80696863	80699956	80696789	80700031	JUNC00004027	23	-	74	75	-304.0	-304.0	-304.0
chrX	80700064	80703479	80699997	80703554	JUNC00004028	23	-	67	75	-304.0	-304.0	-304.0
chrX	80703593	80704677	80703534	80704748	JUNC00004029	21	-	59	71	-304.0	-304.0	-304.0
chrX	80704846	80707426	80704771	80707497	JUNC00004030	25	-	75	71	-304.0	-304.0	-304.0
chrX	80707503	80709427	80707428	80709500	JUNC00004031	26	-	75	73	-304.0	-304.0	-304.0
chrX	80707503	80716156	80707428	80716217	JUNC00004032	5	-	75	61	-304.0	-304.0	-304.0
chrX	80709577	80716156	80709502	80716229	JUNC00004033	17	-	75	73	-304.0	-304.0	-304.0
chrX	80710443	80716156	80710404	80716193	JUNC00004034	1	-	39	37	-304.0	-304.0	-304.0
chrX	80716250	80717572	80716176	80717645	JUNC00004035	24	-	74	73	-304.0	-304.0	-304.0
chrX	80717759	80719488	80717684	80719561	JUNC00004036	17	-	75	73	-304.0	-304.0	-304.0
chrX	80719656	80722561	80719598	80722636	JUNC00004037	19	-	58	75	-304.0	-304.0	-304.0
chrX	80722787	80723747	80722715	80723822	JUNC00004038	27	-	72	75	-304.0	-304.0	-304.0
chrX	80723876	80724932	80723811	80725005	JUNC00004039	15	-	65	73	-304.0	-304.0	-304.0
chrX	80725067	80728751	80724993	80728824	JUNC00004040	9	-	74	73	-304.0	-304.0	-304.0
chrX	80728905	80729915	80728837	80729986	JUNC00004041	22	-	68	71	-304.0	-304.0	-304.0
chrX	80730020	80731087	80730002	80731143	JUNC00004044	1	-	18	56	-304.0	-304.0	-304.0
chrX	80730020	80733455	80729945	80733496	JUNC00004042	24	-	75	41	-304.0	-304.0	-304.0
chrX	80733496	80734117	80733455	80734191	JUNC00004043	30	-	41	74	-304.0	-304.0	-304.0
chrX	80734218	80735126	80734144	80735193	JUNC00004045	22	-	74	67	-304.0	-304.0	-304.0
chrX	80735197	80735987	80735127	80736062	JUNC00004046	20	-	70	75	-304.0	-304.0	-304.0
chrX	80736088	80744031	80736023	80744102	JUNC00004047	21	-	65	71	-304.0	-304.0	-304.0
chrX	80744253	80745568	80744186	80745637	JUNC00004048	17	-	67	69	-304.0	-304.0	-304.0
chrX	80745729	80791853	80745661	80791914	JUNC00004049	11	-	68	61	-304.0	-304.0	-304.0
chrX	80791952	80793621	80791880	80793690	JUNC00004050	21	-	72	69	-304.0	-304.0	-304.0
chrX	80791952	80809012	80791896	80809032	JUNC00004051	1	-	56	20	-304.0	-304.0	-304.0
chrX	80793772	80808538	80793706	80808599	JUNC00004052	16	-	66	61	-304.0	-304.0	-304.0
chrX	80808598	80809012	80808538	80809048	JUNC00004053	25	-	60	36	-304.0	-304.0	-304.0
chrX	80809042	80809245	80809012	80809304	JUNC00004054	14	-	30	59	-304.0	-304.0	-304.0
chrX	80809304	80809440	80809243	80809492	JUNC00004055	9	-	61	52	-304.0	-304.0	-304.0
chrX	80809359	80809440	80809326	80809483	JUNC00004056	1	-	33	43	-304.0	-304.0	-304.0
chrX	80810575	80812191	80810552	80812244	JUNC00004057	1	+	23	53	-304.0	-304.0	-304.0
chrX	80842131	80845610	80842097	80845661	JUNC00004058	2	+	34	51	-304.0	-304.0	-304.0
chrX	80845694	80846132	80845655	80846168	JUNC00004059	1	+	39	36	-304.0	-304.0	-304.0
chrX	81115230	81116203	81115155	81116277	JUNC00004060	104	-	75	74	-304.0	-304.0	-304.0
chrX	81116341	81118431	81116267	81118488	JUNC00004061	92	-	74	57	-304.0	-304.0	-304.0
chrX	81118485	81118729	81118431	81118780	JUNC00004062	105	-	54	51	-304.0	-304.0	-304.0
chrX	81118488	81118729	81118431	81118759	JUNC00004063	10	-	57	30	-304.0	-304.0	-304.0
chrX	81118759	81119787	81118729	81119819	JUNC00004065	86	-	30	32	-304.0	-304.0	-304.0
chrX	81118759	81121534	81118729	81121608	JUNC00004064	10	-	30	74	-304.0	-304.0	-304.0
chrX	81118780	81119787	81118729	81119807	JUNC00004067	1	-	51	20	-304.0	-304.0	-304.0
chrX	81118780	81121534	81118747	81121577	JUNC00004068	1	-	33	43	-304.0	-304.0	-304.0
chrX	81119817	81121534	81119787	81121609	JUNC00004066	69	-	30	75	-304.0	-304.0	-304.0
chrX	81202245	81202436	81202190	81202505	JUNC00004070	7	+	55	69	-304.0	-304.0	-304.0
chrX	81202245	81237117	81202215	81237163	JUNC00004071	1	+	30	46	-304.0	-304.0	-304.0
chrX	81202245	81276983	81202171	81277058	JUNC00004069	693	+	74	75	-304.0	-304.0	-304.0
chrX	81202576	81276983	81202524	81277058	JUNC00004072	3	+	52	75	-304.0	-304.0	-304.0
chrX	81211851	81276983	81211795	81277056	JUNC00004073	2	+	56	73	-304.0	-304.0	-304.0
chrX	81237280	81276983	81237223	81277058	JUNC00004074	7	+	57	75	-304.0	-304.0	-304.0
chrX	81277169	81278330	81277094	81278405	JUNC00004075	791	+	75	75	-304.0	-304.0	-304.0
chrX	81278411	81297194	81278336	81297269	JUNC00004076	844	+	75	75	-304.0	-304.0	-304.0
chrX	81297634	81297966	81297610	81298018	JUNC00004077	1	?	24	52	-304.0	-304.0	-304.0
chrX	81421476	81424561	81421445	81424606	JUNC00004078	1	+	31	45	-304.0	-304.0	-304.0
chrX	84064402	84064970	84064330	84065043	JUNC00004079	9	-	72	73	-304.0	-304.0	-304.0
chrX	84065111	84096193	84065041	84096240	JUNC00004080	5	-	70	47	-304.0	-304.0	-304.0
chrX	84094476	84096193	84094435	84096228	JUNC00004081	1	-	41	35	-304.0	-304.0	-304.0
chrX	84096311	84097771	84096258	84097846	JUNC00004082	3	-	53	75	-304.0	-304.0	-304.0
chrX	84097848	84102036	84097794	84102099	JUNC00004083	4	-	54	63	-304.0	-304.0	-304.0
chrX	84102198	84104498	84102155	84104561	JUNC00004084	3	-	43	63	-304.0	-304.0	-304.0
chrX	84104657	84105786	84104591	84105859	JUNC00004085	10	-	66	73	-304.0	-304.0	-304.0
chrX	84105876	84106364	84105837	84106404	JUNC00004086	2	-	39	40	-304.0	-304.0	-304.0
chrX	84106487	84106909	84106424	84106963	JUNC00004087	6	-	63	54	-304.0	-304.0	-304.0
chrX	84107040	84107622	84106992	84107683	JUNC00004088	4	-	48	61	-304.0	-304.0	-304.0
chrX	84107725	84116228	84107669	84116287	JUNC00004089	4	-	56	59	-304.0	-304.0	-304.0
chrX	84116287	84117059	84116228	84117123	JUNC00004090	4	-	59	64	-304.0	-304.0	-304.0
chrX	84117454	84119884	84117403	84119948	JUNC00004091	5	-	51	64	-304.0	-304.0	-304.0
chrX	84120027	84134781	84119954	84134819	JUNC00004092	6	-	73	38	-304.0	-304.0	-304.0
chrX	84134819	84135103	84134781	84135165	JUNC00004093	6	-	38	62	-304.0	-304.0	-304.0
chrX	84135210	84145477	84135158	84145532	JUNC00004094	2	-	52	55	-304.0	-304.0	-304.0
chrX	84145557	84146977	84145502	84147038	JUNC00004095	3	-	55	61	-304.0	-304.0	-304.0
chrX	84147058	84148041	84147027	84148100	JUNC00004096	2	-	31	59	-304.0	-304.0	-304.0
chrX	84148123	84156074	84148052	84156121	JUNC00004097	6	-	71	47	-304.0	-304.0	-304.0
chrX	84156191	84164327	84156143	84164387	JUNC00004098	3	-	48	60	-304.0	-304.0	-304.0
chrX	84164387	84187818	84164327	84187869	JUNC00004099	3	-	60	51	-304.0	-304.0	-304.0
chrX	84322014	84326177	84321947	84326227	JUNC00004100	3	-	67	50	-304.0	-304.0	-304.0
chrX	84326300	84333758	84326239	84333825	JUNC00004101	4	-	61	67	-304.0	-304.0	-304.0
chrX	84333842	84336800	84333786	84336845	JUNC00004102	5	-	56	45	-304.0	-304.0	-304.0
chrX	84336880	84344249	84336817	84344282	JUNC00004103	5	-	63	33	-304.0	-304.0	-304.0
chrX	84344457	84361465	84344409	84361529	JUNC00004104	9	-	48	64	-304.0	-304.0	-304.0
chrX	84361612	84440531	84361542	84440583	JUNC00004105	2	-	70	52	-304.0	-304.0	-304.0
chrX	84361612	84502341	84361569	84502415	JUNC00004106	2	-	43	74	-304.0	-304.0	-304.0
chrX	84440585	84468471	84440513	84468513	JUNC00004107	3	-	72	42	-304.0	-304.0	-304.0
chrX	84469575	84475250	84469525	84475324	JUNC00004108	8	-	50	74	-304.0	-304.0	-304.0
chrX	84475397	84502341	84475326	84502393	JUNC00004109	5	-	71	52	-304.0	-304.0	-304.0
chrX	84500304	84501428	84500287	84501487	JUNC00004110	1	-	17	59	-304.0	-304.0	-304.0
chrX	84501511	84502341	84501453	84502399	JUNC00004111	2	-	58	58	-304.0	-304.0	-304.0
chrX	85003927	85009660	85003906	85009693	JUNC00004113	1	+	21	33	-304.0	-304.0	-304.0
chrX	85003927	85046445	85003865	85046510	JUNC00004112	13	+	62	65	-304.0	-304.0	-304.0
chrX	85009693	85018221	85009659	85018253	JUNC00004115	1	+	34	32	-304.0	-304.0	-304.0
chrX	85009693	85046445	85009659	85046486	JUNC00004114	2	+	34	41	-304.0	-304.0	-304.0
chrX	85046550	85048315	85046521	85048373	JUNC00004117	2	+	29	58	-304.0	-304.0	-304.0
chrX	85046550	85051388	85046475	85051459	JUNC00004116	22	+	75	71	-304.0	-304.0	-304.0
chrX	85048373	85051388	85048314	85051439	JUNC00004118	2	+	59	51	-304.0	-304.0	-304.0
chrX	85051508	85054343	85051443	85054399	JUNC00004119	23	+	65	56	-304.0	-304.0	-304.0
chrX	85054398	85055826	85054342	85055889	JUNC00004120	19	+	56	63	-304.0	-304.0	-304.0
chrX	85055925	85067126	85055852	85067200	JUNC00004121	15	+	73	74	-304.0	-304.0	-304.0
chrX	85067218	85073997	85067147	85074068	JUNC00004122	17	+	71	71	-304.0	-304.0	-304.0
chrX	85074111	85074273	85074041	85074345	JUNC00004123	29	+	70	72	-304.0	-304.0	-304.0
chrX	85074391	85087589	85074323	85087655	JUNC00004124	31	+	68	66	-304.0	-304.0	-304.0
chrX	85074400	85087589	85074335	85087618	JUNC00004125	2	+	65	29	-304.0	-304.0	-304.0
chrX	85088817	85088866	85088748	85088934	JUNC00004126	17	?	69	68	-304.0	-304.0	-304.0
chrX	85246022	85246929	85245995	85247001	JUNC00004128	3	+	27	72	-304.0	-304.0	-304.0
chrX	85246022	85247546	85245986	85247586	JUNC00004127	1	+	36	40	-304.0	-304.0	-304.0
chrX	85247183	85247546	85247118	85247610	JUNC00004129	4	+	65	64	-304.0	-304.0	-304.0
chrX	85247651	85255258	85247593	85255318	JUNC00004130	4	+	58	60	-304.0	-304.0	-304.0
chrX	85255801	85264274	85255764	85264324	JUNC00004131	2	+	37	50	-304.0	-304.0	-304.0
chrX	85264430	85265117	85264366	85265178	JUNC00004132	7	+	64	61	-304.0	-304.0	-304.0
chrX	85265255	85267277	85265186	85267332	JUNC00004134	4	+	69	55	-304.0	-304.0	-304.0
chrX	85265255	85268293	85265180	85268341	JUNC00004133	6	+	75	48	-304.0	-304.0	-304.0
chrX	85268341	85270002	85268293	85270074	JUNC00004135	10	+	48	72	-304.0	-304.0	-304.0
chrX	85270146	85270650	85270098	85270709	JUNC00004136	5	+	48	59	-304.0	-304.0	-304.0
chrX	85279426	85282202	85279400	85282252	JUNC00004137	1	-	26	50	-304.0	-304.0	-304.0
chrX	85303488	85304342	85303466	85304396	JUNC00004138	1	-	22	54	-304.0	-304.0	-304.0
chrX	85305910	85306180	85305854	85306225	JUNC00004139	2	-	56	45	-304.0	-304.0	-304.0
chrX	85307276	85308123	85307235	85308158	JUNC00004140	1	-	41	35	-304.0	-304.0	-304.0
chrX	85314506	85315706	85314456	85315734	JUNC00004141	3	-	50	28	-304.0	-304.0	-304.0
chrX	85315734	85330948	85315706	85330999	JUNC00004142	3	-	28	51	-304.0	-304.0	-304.0
chrX	85331079	85345859	85331062	85345918	JUNC00004143	1	-	17	59	-304.0	-304.0	-304.0
chrX	85346042	85351349	85345993	85351392	JUNC00004144	2	-	49	43	-304.0	-304.0	-304.0
chrX	85351451	85359549	85351419	85359593	JUNC00004145	1	-	32	44	-304.0	-304.0	-304.0
chrX	85359630	85367691	85359577	85367727	JUNC00004146	2	-	53	36	-304.0	-304.0	-304.0
chrX	85367766	85379172	85367741	85379223	JUNC00004147	1	-	25	51	-304.0	-304.0	-304.0
chrX	85864821	85872408	85864770	85872433	JUNC00004149	1	-	51	25	-304.0	-304.0	-304.0
chrX	85864821	85873051	85864754	85873125	JUNC00004148	21	-	67	74	-304.0	-304.0	-304.0
chrX	85873212	85878964	85873139	85879039	JUNC00004150	15	-	73	75	-304.0	-304.0	-304.0
chrX	85879063	85894187	85878989	85894258	JUNC00004151	24	-	74	71	-304.0	-304.0	-304.0
chrX	85890706	85894187	85890688	85894245	JUNC00004152	1	-	18	58	-304.0	-304.0	-304.0
chrX	85894284	85900645	85894213	85900712	JUNC00004153	30	-	71	67	-304.0	-304.0	-304.0
chrX	85894284	85911260	85894260	85911334	JUNC00004154	2	-	24	74	-304.0	-304.0	-304.0
chrX	85900709	85901083	85900645	85901158	JUNC00004155	30	-	64	75	-304.0	-304.0	-304.0
chrX	85901188	85911260	85901126	85911334	JUNC00004156	17	-	62	74	-304.0	-304.0	-304.0
chrX	85911338	85956152	85911263	85956223	JUNC00004157	23	-	75	71	-304.0	-304.0	-304.0
chrX	85956378	85957854	85956308	85957922	JUNC00004158	12	-	70	68	-304.0	-304.0	-304.0
chrX	85957975	85958860	85957914	85958917	JUNC00004159	10	-	61	57	-304.0	-304.0	-304.0
chrX	85958977	85963664	85958913	85963737	JUNC00004160	16	-	64	73	-304.0	-304.0	-304.0
chrX	85964048	85978766	85963974	85978806	JUNC00004161	4	-	74	40	-304.0	-304.0	-304.0
chrX	85964052	85978766	85963977	85978841	JUNC00004162	17	-	75	75	-304.0	-304.0	-304.0
chrX	85971586	85978766	85971524	85978841	JUNC00004163	5	-	62	75	-304.0	-304.0	-304.0
chrX	85978891	85981736	85978816	85981809	JUNC00004164	40	-	75	73	-304.0	-304.0	-304.0
chrX	85981809	85982653	85981779	85982698	JUNC00004166	1	-	30	45	-304.0	-304.0	-304.0
chrX	85981809	86027490	85981736	86027558	JUNC00004165	31	-	73	68	-304.0	-304.0	-304.0
chrX	85982770	85987054	85982721	85987080	JUNC00004168	1	-	49	26	-304.0	-304.0	-304.0
chrX	86027557	86047483	86027490	86047548	JUNC00004167	29	-	67	65	-304.0	-304.0	-304.0
chrX	87530069	87531213	87530051	87531271	JUNC00004169	1	+	18	58	148.0	152.0	152.0
chrX	87703978	87704097	87703906	87704169	JUNC00004170	10	-	72	72	-304.0	-304.0	-304.0
chrX	88300276	88305205	88300244	88305248	JUNC00004171	1	-	32	43	140.0	140.0	140.0
chrX	92676630	92676663	92676609	92676718	JUNC00004172	1	?	21	55	86.0	-304.0	86.0
chrX	96685190	96735757	96685168	96735790	JUNC00004174	1	+	22	33	-304.0	-304.0	-304.0
chrX	96685190	96738585	96685126	96738653	JUNC00004173	12	+	64	68	-304.0	-304.0	-304.0
chrX	96735790	96738585	96735757	96738605	JUNC00004175	1	+	33	20	-304.0	-304.0	-304.0
chrX	96738762	96758153	96738688	96758227	JUNC00004176	26	+	74	74	-304.0	-304.0	-304.0
chrX	96757152	96793404	96757107	96793432	JUNC00004177	1	+	45	28	-304.0	-304.0	-304.0
chrX	96758258	96763099	96758186	96763121	JUNC00004178	17	+	72	22	-304.0	-304.0	-304.0
chrX	96758258	96881578	96758225	96881621	JUNC00004180	1	+	33	43	-304.0	-304.0	-304.0
chrX	96763120	96881578	96763099	96881649	JUNC00004179	21	+	21	71	-304.0	-304.0	-304.0
chrX	96836959	96840845	96836903	96840864	JUNC00004181	1	-	56	19	134.0	140.0	140.0
chrX	96881718	96912327	96881659	96912400	JUNC00004182	16	+	59	73	-304.0	-304.0	-304.0
chrX	96912402	96912482	96912328	96912536	JUNC00004183	22	+	74	54	-304.0	-304.0	-304.0
chrX	96912552	96916437	96912482	96916512	JUNC00004184	13	+	70	75	-304.0	-304.0	-304.0
chrX	96916574	96918508	96916502	96918583	JUNC00004185	22	+	72	75	-304.0	-304.0	-304.0
chrX	96918617	96930732	96918552	96930807	JUNC00004186	16	+	65	75	-304.0	-304.0	-304.0
chrX	96930843	96937232	96930775	96937305	JUNC00004187	31	+	68	73	-304.0	-304.0	-304.0
chrX	96939382	96942017	96939308	96942088	JUNC00004188	21	+	74	71	-304.0	-304.0	-304.0
chrX	96942136	96945526	96942063	96945591	JUNC00004189	25	+	73	65	-304.0	-304.0	-304.0
chrX	96945591	96948934	96945522	96949004	JUNC00004190	25	+	69	70	-304.0	-304.0	-304.0
chrX	96949039	96957827	96948965	96957902	JUNC00004191	24	+	74	75	-304.0	-304.0	-304.0
chrX	96958148	96965092	96958076	96965163	JUNC00004192	25	+	72	71	-304.0	-304.0	-304.0
chrX	96965207	97072940	96965137	97073010	JUNC00004193	36	+	70	70	-304.0	-304.0	-304.0
chrX	97073042	97075166	97072968	97075238	JUNC00004194	28	+	74	72	-304.0	-304.0	-304.0
chrX	97075261	97099693	97075186	97099766	JUNC00004195	25	+	75	73	-304.0	-304.0	-304.0
chrX	97099795	97114725	97099720	97114795	JUNC00004196	20	+	75	70	-304.0	-304.0	-304.0
chrX	97114965	97141664	97114890	97141733	JUNC00004197	37	+	75	69	-304.0	-304.0	-304.0
chrX	97141794	97247714	97141724	97247789	JUNC00004198	29	+	70	75	-304.0	-304.0	-304.0
chrX	97222324	97236632	97222309	97236693	JUNC00004199	1	-	15	61	-304.0	-304.0	-304.0
chrX	97272209	97323116	97272156	97323139	JUNC00004200	1	+	53	23	-304.0	-304.0	-304.0
chrX	97281484	97375330	97281467	97375389	JUNC00004201	1	-	17	59	-304.0	-304.0	-304.0
chrX	97288663	97343591	97288639	97343643	JUNC00004202	1	-	24	52	-304.0	124.0	124.0
chrX	97305559	97312918	97305544	97312979	JUNC00004203	1	-	15	61	-304.0	-304.0	-304.0
chrX	97348280	97383908	97348208	97383983	JUNC00004204	46	+	72	75	-304.0	-304.0	-304.0
chrX	97384044	97429649	97383970	97429721	JUNC00004205	40	+	74	72	-304.0	-304.0	-304.0
chrX	97429745	97469693	97429671	97469758	JUNC00004206	21	+	74	65	-304.0	-304.0	-304.0
chrX	97429745	97599252	97429671	97599323	JUNC00004207	5	+	74	71	-304.0	-304.0	-304.0
chrX	97529066	97533311	97529002	97533362	JUNC00004208	2	-	64	51	-304.0	-304.0	-304.0
chrX	97533429	97617111	97533381	97617139	JUNC00004209	1	-	48	28	-304.0	-304.0	-304.0
chrX	97603011	97617111	97602996	97617172	JUNC00004210	1	-	15	61	-304.0	-304.0	-304.0
chrX	97997568	98000317	97997527	98000350	JUNC00004211	1	-	41	33	132.0	132.0	132.0
chrX	98741585	98749035	98741564	98749090	JUNC00004212	1	-	21	55	-304.0	-304.0	-304.0
chrX	100629986	100630758	100629937	100630830	JUNC00004213	4	-	49	72	-304.0	-304.0	-304.0
chrX	100630866	100632484	100630794	100632553	JUNC00004214	3	-	72	69	-304.0	-304.0	-304.0
chrX	100632568	100633404	100632531	100633475	JUNC00004215	4	-	37	71	-304.0	-304.0	-304.0
chrX	100633539	100633930	100633479	100633972	JUNC00004216	4	-	60	42	-304.0	-304.0	-304.0
chrX	100634029	100635177	100633958	100635231	JUNC00004217	3	-	71	54	-304.0	-304.0	-304.0
chrX	100635252	100635557	100635177	100635608	JUNC00004218	4	-	75	51	-304.0	-304.0	-304.0
chrX	100686151	100686678	100686130	100686733	JUNC00004219	1	-	21	55	-304.0	-304.0	-304.0
chrX	100691680	100698245	100691655	100698296	JUNC00004220	1	+	25	51	-304.0	-304.0	-304.0
chrX	100820474	100821526	100820419	100821601	JUNC00004221	59	+	55	75	-304.0	-304.0	-304.0
chrX	100821605	100822250	100821530	100822322	JUNC00004222	89	+	75	72	-304.0	-304.0	-304.0
chrX	100822420	100823291	100822345	100823366	JUNC00004223	97	+	75	75	-304.0	-304.0	-304.0
chrX	100823428	100823885	100823354	100823960	JUNC00004224	113	+	74	75	-304.0	-304.0	-304.0
chrX	100824005	100824119	100823931	100824193	JUNC00004225	106	+	74	74	-304.0	-304.0	-304.0
chrX	100824257	100826633	100824182	100826704	JUNC00004226	83	+	75	71	-304.0	-304.0	-304.0
chrX	100824257	100826684	100824182	100826727	JUNC00004227	7	+	75	43	-304.0	-304.0	-304.0
chrX	100826757	100828039	100826682	100828102	JUNC00004228	82	+	75	63	-304.0	-304.0	-304.0
chrX	100828102	100831514	100828033	100831586	JUNC00004229	76	+	69	72	-304.0	-304.0	-304.0
chrX	100830867	100831514	100830815	100831586	JUNC00004230	4	+	52	72	-304.0	-304.0	-304.0
chrX	100831656	100832733	100831582	100832807	JUNC00004231	94	+	74	74	-304.0	-304.0	-304.0
chrX	100832909	100833179	100832834	100833251	JUNC00004232	106	+	75	72	-304.0	-304.0	-304.0
chrX	100833280	100833325	100833211	100833345	JUNC00004233	2	+	69	20	-304.0	-304.0	-304.0
chrX	100833472	100837338	100833397	100837409	JUNC00004234	107	+	75	71	-304.0	-304.0	-304.0
chrX	100837449	100838238	100837375	100838313	JUNC00004235	87	+	74	75	-304.0	-304.0	-304.0
chrX	100838364	100840713	100838290	100840788	JUNC00004236	61	+	74	75	-304.0	-304.0	-304.0
chrX	100838364	100840777	100838331	100840820	JUNC00004237	1	+	33	43	-304.0	-304.0	-304.0
chrX	100983451	101009635	100983426	101009685	JUNC00004238	1	+	25	50	-304.0	-304.0	-304.0
chrX	101001498	101003958	101001478	101004014	JUNC00004239	1	+	20	56	-304.0	-304.0	-304.0
chrX	101003491	101061329	101003438	101061352	JUNC00004240	1	+	53	23	128.0	128.0	128.0
chrX	101009622	101010373	101009574	101010401	JUNC00004241	1	-	48	28	-304.0	-304.0	-304.0
chrX	101010707	101018970	101010633	101019041	JUNC00004242	40	-	74	71	-304.0	-304.0	-304.0
chrX	101013739	101018970	101013667	101019044	JUNC00004243	8	-	72	74	-304.0	-304.0	-304.0
chrX	101019070	101019283	101018995	101019357	JUNC00004244	56	-	75	74	-304.0	-304.0	-304.0
chrX	101019403	101020486	101019330	101020561	JUNC00004245	73	-	73	75	-304.0	-304.0	-304.0
chrX	101021315	101021967	101021240	101022041	JUNC00004246	39	-	75	74	-304.0	-304.0	-304.0
chrX	101021315	101035612	101021241	101035654	JUNC00004247	2	-	74	42	-304.0	-304.0	-304.0
chrX	101022062	101023469	101021991	101023544	JUNC00004248	51	-	71	75	-304.0	-304.0	-304.0
chrX	101022062	101035612	101022032	101035658	JUNC00004249	1	-	30	46	-304.0	-304.0	-304.0
chrX	101023616	101035612	101023545	101035683	JUNC00004250	36	-	71	71	-304.0	-304.0	-304.0
chrX	101035683	101036973	101035612	101037047	JUNC00004251	49	-	71	74	-304.0	-304.0	-304.0
chrX	101037073	101037916	101036998	101037991	JUNC00004252	52	-	75	75	-304.0	-304.0	-304.0
chrX	101037073	101041316	101037040	101041359	JUNC00004253	1	-	33	43	-304.0	-304.0	-304.0
chrX	101038051	101041316	101037978	101041371	JUNC00004254	26	-	73	55	-304.0	-304.0	-304.0
chrX	101038051	101042232	101038028	101042285	JUNC00004255	1	-	23	53	-304.0	-304.0	-304.0
chrX	101041371	101042041	101041315	101042114	JUNC00004257	24	-	56	73	-304.0	-304.0	-304.0
chrX	101041371	101042197	101041351	101042253	JUNC00004258	1	-	20	56	-304.0	-304.0	-304.0
chrX	101041371	101042232	101041314	101042293	JUNC00004256	7	-	57	61	-304.0	-304.0	-304.0
chrX	101042312	101051250	101042239	101051320	JUNC00004259	12	-	73	70	-304.0	-304.0	-304.0
chrX	101042312	101051643	101042249	101051663	JUNC00004261	2	-	63	20	-304.0	-304.0	-304.0
chrX	101042312	101051783	101042240	101051853	JUNC00004260	18	-	72	70	-304.0	-304.0	-304.0
chrX	101042312	101051816	101042262	101051890	JUNC00004262	6	-	50	74	-304.0	-304.0	-304.0
chrX	101051366	101051783	101051294	101051825	JUNC00004263	3	-	72	42	-304.0	-304.0	-304.0
chrX	101051733	101051816	101051704	101051863	JUNC00004264	1	-	29	47	-304.0	-304.0	-304.0
chrX	101065081	101146816	101065046	101146856	JUNC00004265	1	-	35	40	-304.0	-304.0	-304.0
chrX	101098234	101098443	101098199	101098516	JUNC00004267	13	+	35	73	-304.0	-304.0	-304.0
chrX	101098248	101098443	101098195	101098515	JUNC00004266	16	+	53	72	-304.0	-304.0	-304.0
chrX	101098539	101099808	101098464	101099867	JUNC00004268	12	+	75	59	-304.0	-304.0	-304.0
chrX	101098539	101101057	101098464	101101129	JUNC00004269	28	+	75	72	-304.0	-304.0	-304.0
chrX	101098843	101099808	101098816	101099857	JUNC00004270	1	+	27	49	-304.0	-304.0	-304.0
chrX	101100130	101101057	101100100	101101115	JUNC00004271	2	+	30	58	-304.0	-304.0	-304.0
chrX	101100558	101121945	101100519	101121979	JUNC00004272	1	+	39	34	-304.0	-304.0	-304.0
chrX	101101296	101102273	101101227	101102348	JUNC00004273	43	+	69	75	-304.0	-304.0	-304.0
chrX	101102411	101109472	101102338	101109547	JUNC00004274	43	+	73	75	-304.0	-304.0	-304.0
chrX	101106530	101166237	101106507	101166290	JUNC00004275	1	-	23	53	-304.0	-304.0	-304.0
chrX	101109591	101109890	101109517	101109961	JUNC00004276	35	+	74	71	-304.0	-304.0	-304.0
chrX	101109596	101109894	101109553	101109941	JUNC00004277	2	-	43	47	-304.0	-304.0	-304.0
chrX	101109998	101120401	101109924	101120450	JUNC00004278	23	+	74	49	-304.0	-304.0	-304.0
chrX	101120450	101120737	101120400	101120784	JUNC00004279	30	+	50	47	-304.0	-304.0	-304.0
chrX	101120784	101122184	101120740	101122218	JUNC00004281	2	+	44	34	-304.0	-304.0	-304.0
chrX	101120784	101126708	101120736	101126765	JUNC00004280	31	+	48	57	-304.0	-304.0	-304.0
chrX	101121916	101166237	101121893	101166290	JUNC00004282	1	-	23	53	-304.0	-304.0	-304.0
chrX	101126798	101127137	101126725	101127210	JUNC00004283	35	+	73	73	-304.0	-304.0	-304.0
chrX	101127266	101127497	101127193	101127569	JUNC00004284	34	+	73	72	-304.0	-304.0	-304.0
chrX	101127665	101128715	101127592	101128787	JUNC00004285	32	+	73	72	-304.0	-304.0	-304.0
chrX	101128836	101129981	101128765	101130056	JUNC00004286	24	+	71	75	-304.0	-304.0	-304.0
chrX	101130073	101132189	101129998	101132262	JUNC00004287	40	+	75	73	-304.0	-304.0	-304.0
chrX	101132307	101132391	101132233	101132456	JUNC00004288	46	+	74	65	-304.0	-304.0	-304.0
chrX	101132456	101136931	101132421	101136972	JUNC00004290	1	+	35	41	-304.0	-304.0	-304.0
chrX	101132456	101140665	101132390	101140737	JUNC00004289	40	+	66	72	-304.0	-304.0	-304.0
chrX	101132456	101145063	101132431	101145114	JUNC00004291	1	+	25	51	-304.0	-304.0	-304.0
chrX	101140760	101141384	101140721	101141421	JUNC00004293	1	+	39	37	-304.0	-304.0	-304.0
chrX	101140760	101145063	101140686	101145138	JUNC00004292	33	+	74	75	-304.0	-304.0	-304.0
chrX	101145199	101146152	101145124	101146223	JUNC00004294	24	+	75	71	-304.0	-304.0	-304.0
chrX	101146277	101147762	101146204	101147811	JUNC00004295	34	+	73	49	-304.0	-304.0	-304.0
chrX	101147811	101147942	101147760	101148016	JUNC00004296	33	+	51	74	-304.0	-304.0	-304.0
chrX	101148161	101153315	101148127	101153360	JUNC00004301	2	+	34	45	-304.0	-304.0	-304.0
chrX	101148161	101161527	101148087	101161570	JUNC00004297	23	+	74	43	-304.0	-304.0	-304.0
chrX	101148161	101161537	101148116	101161569	JUNC00004300	2	+	45	32	-304.0	-304.0	-304.0
chrX	101148161	101162832	101148090	101162906	JUNC00004298	8	+	71	74	-304.0	-304.0	-304.0
chrX	101148161	101181811	101148103	101181829	JUNC00004299	1	+	58	18	-304.0	-304.0	-304.0
chrX	101161569	101162832	101161527	101162905	JUNC00004302	26	+	42	73	-304.0	-304.0	-304.0
chrX	101166201	101178455	101166182	101178512	JUNC00004303	1	+	19	57	-304.0	-304.0	-304.0
chrX	101237775	101238980	101237743	101239024	JUNC00004304	1	+	32	44	-304.0	-304.0	-304.0
chrX	101239101	101241667	101239047	101241711	JUNC00004305	3	+	54	44	-304.0	-304.0	-304.0
chrX	101248290	101248513	101248260	101248572	JUNC00004306	2	+	30	59	-304.0	-304.0	-304.0
chrX	101251083	101252604	101251046	101252643	JUNC00004307	1	+	37	39	-304.0	-304.0	-304.0
chrX	101252716	101254424	101252663	101254447	JUNC00004308	1	+	53	23	-304.0	-304.0	-304.0
chrX	101346660	101348532	101346586	101348607	JUNC00004309	90	-	74	75	-304.0	-304.0	-304.0
chrX	101348401	101348532	101348361	101348607	JUNC00004310	4	-	40	75	-304.0	-304.0	-304.0
chrX	101349956	101350999	101349881	101351055	JUNC00004313	4	-	75	56	-304.0	-304.0	-304.0
chrX	101349956	101353193	101349881	101353268	JUNC00004311	241	-	75	75	-304.0	-304.0	-304.0
chrX	101349956	101354629	101349881	101354674	JUNC00004312	3	-	75	45	-304.0	-304.0	-304.0
chrX	101353351	101353869	101353276	101353944	JUNC00004314	322	-	75	75	-304.0	-304.0	-304.0
chrX	101353988	101354629	101353913	101354695	JUNC00004315	308	-	75	66	-304.0	-304.0	-304.0
chrX	101354694	101356051	101354619	101356126	JUNC00004316	297	-	75	75	-304.0	-304.0	-304.0
chrX	101356268	101356783	101356193	101356858	JUNC00004317	304	-	75	75	-304.0	-304.0	-304.0
chrX	101356955	101357508	101356880	101357583	JUNC00004318	412	-	75	75	-304.0	-304.0	-304.0
chrX	101357583	101358309	101357508	101358384	JUNC00004319	423	-	75	75	-304.0	-304.0	-304.0
chrX	101358437	101358616	101358362	101358691	JUNC00004320	343	-	75	75	-304.0	-304.0	-304.0
chrX	101358696	101359292	101358621	101359347	JUNC00004321	387	-	75	55	-304.0	-304.0	-304.0
chrX	101359347	101360087	101359291	101360151	JUNC00004322	393	-	56	64	-304.0	-304.0	-304.0
chrX	101359347	101360093	101359312	101360132	JUNC00004324	1	-	35	39	-304.0	-304.0	-304.0
chrX	101359347	101360567	101359293	101360642	JUNC00004323	12	-	54	75	-304.0	-304.0	-304.0
chrX	101360150	101360567	101360085	101360642	JUNC00004325	370	-	65	75	-304.0	-304.0	-304.0
chrX	101360755	101362172	101360680	101362240	JUNC00004326	328	-	75	68	-304.0	-304.0	-304.0
chrX	101362240	101362560	101362172	101362635	JUNC00004327	307	-	68	75	-304.0	-304.0	-304.0
chrX	101362689	101369997	101362614	101370071	JUNC00004328	347	-	75	74	-304.0	-304.0	-304.0
chrX	101370079	101371632	101370006	101371702	JUNC00004329	276	-	73	70	-304.0	-304.0	-304.0
chrX	101371701	101374535	101371630	101374610	JUNC00004330	329	-	71	75	-304.0	-304.0	-304.0
chrX	101374632	101375143	101374557	101375218	JUNC00004331	20	-	75	75	-304.0	-304.0	-304.0
chrX	101374634	101375143	101374559	101375218	JUNC00004332	313	-	75	75	-304.0	-304.0	-304.0
chrX	101375307	101386061	101375232	101386107	JUNC00004333	7	-	75	46	-304.0	-304.0	-304.0
chrX	101375314	101386050	101375239	101386073	JUNC00004334	3	-	75	23	-304.0	-304.0	-304.0
chrX	101375314	101386061	101375239	101386136	JUNC00004335	345	-	75	75	-304.0	-304.0	-304.0
chrX	101391046	101391458	101390972	101391533	JUNC00004336	263	+	74	75	-304.0	-304.0	-304.0
chrX	101391235	101391458	101391207	101391533	JUNC00004337	7	+	28	75	-304.0	-304.0	-304.0
chrX	101391345	101391458	101391297	101391533	JUNC00004338	93	+	48	75	-304.0	-304.0	-304.0
chrX	101391392	101391458	101391328	101391533	JUNC00004339	63	+	64	75	-304.0	-304.0	-304.0
chrX	101391564	101391754	101391489	101391825	JUNC00004340	3168	+	75	71	-304.0	-304.0	-304.0
chrX	101391564	101391759	101391523	101391791	JUNC00004341	1	+	41	32	-304.0	-304.0	-304.0
chrX	101391768	101391794	101391754	101391816	JUNC00004342	1	+	14	22	100.0	100.0	100.0
chrX	101391822	101395334	101391753	101395409	JUNC00004344	828	+	69	75	-304.0	-304.0	-304.0
chrX	101391822	101395727	101391753	101395785	JUNC00004343	80	+	69	58	-304.0	-304.0	-304.0
chrX	101392095	101395334	101392073	101395388	JUNC00004345	1	+	22	54	-304.0	-304.0	-304.0
chrX	101395176	101395267	101395135	101395302	JUNC00004346	1	+	41	35	-304.0	-304.0	-304.0
chrX	101395457	101395727	101395382	101395785	JUNC00004347	255	+	75	58	-304.0	-304.0	-304.0
chrX	101398099	101398369	101398024	101398444	JUNC00004348	79	-	75	75	-304.0	-304.0	-304.0
chrX	101398099	101398784	101398050	101398823	JUNC00004349	2	-	49	39	-304.0	-304.0	-304.0
chrX	101398567	101398784	101398492	101398858	JUNC00004350	61	-	75	74	-304.0	-304.0	-304.0
chrX	101398946	101399743	101398900	101399798	JUNC00004352	2	-	46	55	-304.0	-304.0	-304.0
chrX	101398946	101400665	101398872	101400740	JUNC00004351	60	-	74	75	-304.0	-304.0	-304.0
chrX	101400757	101401631	101400683	101401703	JUNC00004353	59	-	74	72	-304.0	-304.0	-304.0
chrX	101401809	101403810	101401734	101403885	JUNC00004354	61	-	75	75	-304.0	-304.0	-304.0
chrX	101403985	101407709	101403910	101407782	JUNC00004355	60	-	75	73	-304.0	-304.0	-304.0
chrX	101408307	101411935	101408237	101412010	JUNC00004356	29	+	70	75	-304.0	-304.0	-304.0
chrX	101408319	101411935	101408244	101412010	JUNC00004357	150	+	75	75	-304.0	-304.0	-304.0
chrX	101408516	101411935	101408470	101411993	JUNC00004358	3	+	46	58	-304.0	-304.0	-304.0
chrX	101418370	101418909	101418307	101418954	JUNC00004359	4	+	63	45	-304.0	-304.0	-304.0
chrX	101422158	101424006	101422104	101424028	JUNC00004360	1	+	54	22	110.0	-304.0	110.0
chrX	101444155	101445997	101444081	101445999	JUNC00004361	1	+	74	2	-304.0	-304.0	-304.0
chrX	101446044	101447493	101446008	101447564	JUNC00004363	4	+	36	71	-304.0	-304.0	-304.0
chrX	101446044	101486022	101446008	101486062	JUNC00004362	1	+	36	40	-304.0	-304.0	-304.0
chrX	101486092	101487192	101486047	101487244	JUNC00004364	2	+	45	52	-304.0	-304.0	-304.0
chrX	101486098	101487192	101486067	101487263	JUNC00004365	3	+	31	71	-304.0	-304.0	-304.0
chrX	101487272	101487607	101487201	101487671	JUNC00004366	2	+	71	64	-304.0	-304.0	-304.0
chrX	101487691	101488007	101487621	101488013	JUNC00004367	1	+	70	6	-304.0	-304.0	-304.0
chrX	101487691	101488043	101487623	101488099	JUNC00004368	3	+	68	56	-304.0	-304.0	-304.0
chrX	101488099	101488443	101488047	101488495	JUNC00004369	3	+	52	52	-304.0	-304.0	-304.0
chrX	101489315	101498144	101489240	101498194	JUNC00004370	2	+	75	50	-304.0	-304.0	-304.0
chrX	101499366	101504936	101499340	101504986	JUNC00004371	1	+	26	50	-304.0	-304.0	-304.0
chrX	101505355	101509358	101505286	101509365	JUNC00004372	1	+	69	7	-304.0	-304.0	-304.0
chrX	101509427	101509589	101509360	101509598	JUNC00004373	1	+	67	9	-304.0	-304.0	-304.0
chrX	101511055	101531643	101511030	101531697	JUNC00004374	2	+	25	54	-304.0	-304.0	-304.0
chrX	101550660	101550973	101550632	101551021	JUNC00004375	1	+	28	48	-304.0	-304.0	-304.0
chrX	101551024	101551568	101550987	101551606	JUNC00004376	1	+	37	38	-304.0	-304.0	-304.0
chrX	101551633	101552808	101551590	101552857	JUNC00004377	2	+	43	49	-304.0	-304.0	-304.0
chrX	101615467	101616671	101615401	101616723	JUNC00004378	2	-	66	52	-304.0	-304.0	-304.0
chrX	101615760	101616671	101615685	101616746	JUNC00004379	130	-	75	75	-304.0	-304.0	-304.0
chrX	101616766	101617066	101616691	101617118	JUNC00004381	7	-	75	52	-304.0	-304.0	-304.0
chrX	101616766	101617282	101616695	101617326	JUNC00004384	3	-	71	44	-304.0	-304.0	-304.0
chrX	101616766	101617291	101616709	101617347	JUNC00004385	5	-	57	56	-304.0	-304.0	-304.0
chrX	101616766	101617490	101616691	101617532	JUNC00004380	6	-	75	42	-304.0	-304.0	-304.0
chrX	101616766	101617502	101616691	101617577	JUNC00004382	187	-	75	75	-304.0	-304.0	-304.0
chrX	101616766	101617884	101616692	101617944	JUNC00004383	10	-	74	60	-304.0	-304.0	-304.0
chrX	101617370	101617502	101617309	101617577	JUNC00004386	10	-	61	75	-304.0	-304.0	-304.0
chrX	101617584	101617884	101617511	101617959	JUNC00004387	175	-	73	75	-304.0	-304.0	-304.0
chrX	101623276	101623785	101623210	101623859	JUNC00004389	27	+	66	74	-304.0	-304.0	-304.0
chrX	101623276	101623813	101623205	101623888	JUNC00004388	59	+	71	75	-304.0	-304.0	-304.0
chrX	101623430	101623785	101623358	101623849	JUNC00004390	4	+	72	64	-304.0	-304.0	-304.0
chrX	101623430	101623813	101623379	101623844	JUNC00004391	2	+	51	31	-304.0	-304.0	-304.0
chrX	101623893	101624157	101623818	101624218	JUNC00004392	98	+	75	61	-304.0	-304.0	-304.0
chrX	101624218	101624479	101624152	101624550	JUNC00004393	123	+	66	71	-304.0	-304.0	-304.0
chrX	101624550	101624833	101624477	101624908	JUNC00004394	111	+	73	75	-304.0	-304.0	-304.0
chrX	101656176	101656227	101656135	101656262	JUNC00004395	1	?	41	35	-304.0	-304.0	-304.0
chrX	101657715	101658072	101657650	101658136	JUNC00004396	40	-	65	64	-304.0	-304.0	-304.0
chrX	101658142	101658460	101658072	101658526	JUNC00004397	30	-	70	66	-304.0	-304.0	-304.0
chrX	101658142	101658491	101658092	101658551	JUNC00004398	11	-	50	60	-304.0	-304.0	-304.0
chrX	101658525	101659075	101658460	101659147	JUNC00004399	20	-	65	72	-304.0	-304.0	-304.0
chrX	101658569	101659075	101658502	101659150	JUNC00004400	16	-	67	75	-304.0	-304.0	-304.0
chrX	101659148	101659418	101659074	101659483	JUNC00004401	23	-	74	65	-304.0	-304.0	-304.0
chrX	101659148	101659430	101659120	101659478	JUNC00004403	1	-	28	48	-304.0	-304.0	-304.0
chrX	101659148	101659757	101659074	101659831	JUNC00004402	9	-	74	74	-304.0	-304.0	-304.0
chrX	101659501	101659757	101659427	101659832	JUNC00004404	25	-	74	75	-304.0	-304.0	-304.0
chrX	101840895	101841015	101840826	101841087	JUNC00004405	2	-	69	72	-304.0	-304.0	-304.0
chrX	101884821	101886631	101884775	101886661	JUNC00004406	1	-	46	30	-304.0	-304.0	-304.0
chrX	101895879	101897867	101895848	101897912	JUNC00004407	1	-	31	45	-304.0	-304.0	-304.0
chrX	102154302	102154743	102154271	102154788	JUNC00004408	1	-	31	45	-304.0	-304.0	-304.0
chrX	102154810	102155858	102154751	102155888	JUNC00004409	3	-	59	30	-304.0	-304.0	-304.0
chrX	102599266	102599347	102599217	102599374	JUNC00004410	1	+	49	27	-304.0	-304.0	-304.0
chrX	102599572	102599705	102599538	102599776	JUNC00004411	3	+	34	71	-304.0	-304.0	-304.0
chrX	102599572	102599711	102599545	102599781	JUNC00004412	6	+	27	70	-304.0	-304.0	-304.0
chrX	102599847	102600919	102599789	102600992	JUNC00004415	8	+	58	73	-304.0	-304.0	-304.0
chrX	102599847	102601463	102599781	102601509	JUNC00004414	17	+	66	46	-304.0	-304.0	-304.0
chrX	102599847	102605481	102599779	102605553	JUNC00004413	4	+	68	72	-304.0	-304.0	-304.0
chrX	102599859	102600919	102599792	102600992	JUNC00004416	4	+	67	73	-304.0	-304.0	-304.0
chrX	102599859	102601463	102599807	102601483	JUNC00004417	1	+	52	20	-304.0	-304.0	-304.0
chrX	102601032	102601463	102600981	102601509	JUNC00004420	8	+	51	46	-304.0	-304.0	-304.0
chrX	102601509	102601879	102601463	102601952	JUNC00004419	21	+	46	73	-304.0	-304.0	-304.0
chrX	102601509	102605481	102601462	102605523	JUNC00004418	6	+	47	42	-304.0	-304.0	-304.0
chrX	102601977	102605481	102601924	102605504	JUNC00004421	1	+	53	23	-304.0	-304.0	-304.0
chrX	102602102	102605481	102602070	102605525	JUNC00004422	1	+	32	44	-304.0	-304.0	-304.0
chrX	102605653	102639399	102605579	102639470	JUNC00004424	13	+	74	71	-304.0	-304.0	-304.0
chrX	102605653	102649953	102605579	102649987	JUNC00004423	2	+	74	34	-304.0	-304.0	-304.0
chrX	102625875	102639399	102625838	102639438	JUNC00004425	1	+	37	39	-304.0	-304.0	-304.0
chrX	102652898	102653220	102652864	102653262	JUNC00004426	1	+	34	42	-304.0	-304.0	-304.0
chrX	102653298	102653579	102653268	102653633	JUNC00004427	2	+	30	54	-304.0	-304.0	-304.0
chrX	102713217	102713781	102713189	102713829	JUNC00004428	1	+	28	48	-304.0	-304.0	-304.0
chrX	102713849	102714188	102713830	102714245	JUNC00004429	1	+	19	57	-304.0	-304.0	-304.0
chrX	102720821	102720956	102720790	102721027	JUNC00004430	2	+	31	71	-304.0	-304.0	-304.0
chrX	102721091	102747816	102721048	102747881	JUNC00004431	4	+	43	65	-304.0	-304.0	-304.0
chrX	102769341	102770351	102769270	102770417	JUNC00004432	8	+	71	66	-304.0	-304.0	-304.0
chrX	102769437	102770351	102769410	102770393	JUNC00004433	1	+	27	42	-304.0	-304.0	-304.0
chrX	102817082	102825992	102817018	102826052	JUNC00004434	9	+	64	60	-304.0	-304.0	-304.0
chrX	102826169	102826968	102826112	102827032	JUNC00004435	3	+	57	64	-304.0	-304.0	-304.0
chrX	102827144	102839800	102827099	102839863	JUNC00004436	2	+	45	63	-304.0	-304.0	-304.0
chrX	102830147	102834627	102830119	102834674	JUNC00004437	1	+	28	47	-304.0	-304.0	-304.0
chrX	102839863	102845856	102839841	102845910	JUNC00004438	1	+	22	54	-304.0	-304.0	-304.0
chrX	102839972	102845856	102839924	102845886	JUNC00004439	2	+	48	30	-304.0	-304.0	-304.0
chrX	102843407	102845856	102843365	102845890	JUNC00004440	1	+	42	34	-304.0	-304.0	-304.0
chrX	102846020	102865041	102845961	102865116	JUNC00004441	5	+	59	75	-304.0	-304.0	-304.0
chrX	102865152	102884142	102865149	102884215	JUNC00004443	1	+	3	73	-304.0	-304.0	-304.0
chrX	102865152	102897573	102865094	102897633	JUNC00004442	3	+	58	60	-304.0	-304.0	-304.0
chrX	102878119	102884142	102878091	102884190	JUNC00004444	1	+	28	48	-304.0	-304.0	-304.0
chrX	102884808	102897573	102884742	102897595	JUNC00004445	2	+	66	22	-304.0	-304.0	-304.0
chrX	102897764	102900749	102897693	102900813	JUNC00004446	5	+	71	64	-304.0	-304.0	-304.0
chrX	102900832	102901022	102900772	102901090	JUNC00004447	4	+	60	68	-304.0	-304.0	-304.0
chrX	102901133	102901630	102901113	102901686	JUNC00004448	1	+	20	56	-304.0	-304.0	-304.0
chrX	102901771	102905660	102901712	102905720	JUNC00004449	6	+	59	60	-304.0	-304.0	-304.0
chrX	102905737	102910828	102905715	102910882	JUNC00004451	1	+	22	54	-304.0	-304.0	-304.0
chrX	102905737	102958647	102905682	102958668	JUNC00004450	1	+	55	21	-304.0	-304.0	-304.0
chrX	102958701	102961605	102958666	102961646	JUNC00004452	1	+	35	41	-304.0	-304.0	-304.0
chrX	102959133	102959407	102959093	102959443	JUNC00004453	1	+	40	36	-304.0	-304.0	-304.0
chrX	103215238	103215681	103215171	103215738	JUNC00004454	4	+	67	57	-304.0	-304.0	-304.0
chrX	103215764	103216148	103215705	103216223	JUNC00004455	9	+	59	75	-304.0	-304.0	-304.0
chrX	103254017	103254604	103253942	103254678	JUNC00004457	88	-	75	74	-304.0	-304.0	-304.0
chrX	103254017	103255077	103253942	103255143	JUNC00004456	17	-	75	66	-304.0	-304.0	-304.0
chrX	103254677	103255077	103254604	103255149	JUNC00004458	83	-	73	72	-304.0	-304.0	-304.0
chrX	103309981	103310357	103309910	103310429	JUNC00004459	18	-	71	72	-304.0	-304.0	-304.0
chrX	103310433	103310859	103310359	103310931	JUNC00004460	12	-	74	72	-304.0	-304.0	-304.0
chrX	103331040	103331376	103330995	103331407	JUNC00004461	1	+	45	31	-304.0	-304.0	-304.0
chrX	103356606	103357082	103356532	103357157	JUNC00004462	29	+	74	75	-304.0	-304.0	-304.0
chrX	103356606	103357614	103356533	103357684	JUNC00004463	6	+	73	70	-304.0	-304.0	-304.0
chrX	103357161	103357614	103357091	103357686	JUNC00004464	27	+	70	72	-304.0	-304.0	-304.0
chrX	103376613	103377027	103376549	103377098	JUNC00004465	12	+	64	71	-304.0	-304.0	-304.0
chrX	103377106	103377462	103377060	103377506	JUNC00004467	2	+	46	44	-304.0	-304.0	-304.0
chrX	103377106	103377509	103377031	103377580	JUNC00004466	19	+	75	71	-304.0	-304.0	-304.0
chrX	103449410	103450496	103449378	103450540	JUNC00004468	1	+	32	44	-304.0	-304.0	-304.0
chrX	103478212	103517373	103478197	103517434	JUNC00004469	1	-	15	61	-304.0	-304.0	-304.0
chrX	103486459	103491213	103486442	103491271	JUNC00004470	1	+	17	58	-304.0	-304.0	-304.0
chrX	103497613	103499776	103497554	103499818	JUNC00004471	4	+	59	42	-304.0	-304.0	-304.0
chrX	103517525	103519369	103517453	103519407	JUNC00004472	2	-	72	38	-304.0	-304.0	-304.0
chrX	103526230	103526631	103526192	103526669	JUNC00004473	1	-	38	38	-304.0	-304.0	-304.0
chrX	103530355	103530747	103530284	103530784	JUNC00004474	2	-	71	37	-304.0	-304.0	-304.0
chrX	103537956	103538135	103537941	103538196	JUNC00004475	1	-	15	61	-304.0	-304.0	-304.0
chrX	103538228	103554575	103538183	103554606	JUNC00004476	1	-	45	31	-304.0	-304.0	-304.0
chrX	103585624	103585858	103585567	103585930	JUNC00004478	6	+	57	72	-304.0	-304.0	-304.0
chrX	103585624	103585969	103585568	103585994	JUNC00004479	2	+	56	25	-304.0	-304.0	-304.0
chrX	103585624	103586218	103585550	103586290	JUNC00004477	135	+	74	72	-304.0	-304.0	-304.0
chrX	103585683	103586218	103585634	103586245	JUNC00004480	1	+	49	27	-304.0	-304.0	-304.0
chrX	103586291	103586648	103586220	103586723	JUNC00004481	175	+	71	75	-304.0	-304.0	-304.0
chrX	103586291	103586653	103586221	103586728	JUNC00004482	19	+	70	75	-304.0	-304.0	-304.0
chrX	103586861	103586948	103586816	103586977	JUNC00004483	1	?	45	29	-304.0	-304.0	-304.0
chrX	103608058	103608603	103608001	103608674	JUNC00004485	17	+	57	71	-304.0	-304.0	-304.0
chrX	103608070	103608603	103608001	103608674	JUNC00004484	14	+	69	71	-304.0	-304.0	-304.0
chrX	103608673	103609037	103608599	103609112	JUNC00004486	76	+	74	75	-304.0	-304.0	-304.0
chrX	103608673	103609042	103608603	103609088	JUNC00004487	3	+	70	46	-304.0	-304.0	-304.0
chrX	103628793	103629493	103628720	103629547	JUNC00004488	8	+	73	54	-304.0	-304.0	-304.0
chrX	103629025	103629493	103628951	103629566	JUNC00004489	23	+	74	73	-304.0	-304.0	-304.0
chrX	103629561	103629884	103629487	103629959	JUNC00004490	37	+	74	75	-304.0	-304.0	-304.0
chrX	103629573	103629884	103629498	103629959	JUNC00004491	10	+	75	75	-304.0	-304.0	-304.0
chrX	103629803	103629884	103629730	103629949	JUNC00004492	5	+	73	65	-304.0	-304.0	-304.0
chrX	103677051	103678498	103676976	103678572	JUNC00004493	335	-	75	74	-304.0	-304.0	-304.0
chrX	103677051	103684680	103677009	103684714	JUNC00004495	1	-	42	34	-304.0	-304.0	-304.0
chrX	103677051	103685170	103676980	103685221	JUNC00004494	9	-	71	51	-304.0	-304.0	-304.0
chrX	103678600	103684680	103678528	103684730	JUNC00004496	32	-	72	50	-304.0	-304.0	-304.0
chrX	103678600	103685170	103678528	103685241	JUNC00004497	126	-	72	71	-304.0	-304.0	-304.0
chrX	103678620	103684680	103678569	103684704	JUNC00004499	1	-	51	24	-304.0	-304.0	-304.0
chrX	103678620	103685170	103678546	103685245	JUNC00004498	15	-	74	75	-304.0	-304.0	-304.0
chrX	103678651	103684680	103678577	103684730	JUNC00004502	18	-	74	50	-304.0	-304.0	-304.0
chrX	103678651	103685170	103678577	103685245	JUNC00004501	51	-	74	75	-304.0	-304.0	-304.0
chrX	103684729	103685170	103684680	103685241	JUNC00004500	73	-	49	71	-304.0	-304.0	-304.0
chrX	103685260	103686026	103685214	103686056	JUNC00004506	1	-	46	30	-304.0	-304.0	-304.0
chrX	103685260	103686630	103685185	103686695	JUNC00004503	255	-	75	65	-304.0	-304.0	-304.0
chrX	103685260	103686884	103685185	103686914	JUNC00004504	2	-	75	30	-304.0	-304.0	-304.0
chrX	103685260	103687988	103685185	103688061	JUNC00004505	45	-	75	73	-304.0	-304.0	-304.0
chrX	103689480	103691418	103689412	103691426	JUNC00004507	1	+	68	8	-304.0	-304.0	-304.0
chrX	103825826	103827004	103825795	103827045	JUNC00004508	1	-	31	41	-304.0	-304.0	-304.0
chrX	103827078	103832059	103827054	103832111	JUNC00004509	1	-	24	52	-304.0	-304.0	-304.0
chrX	103913687	103914736	103913641	103914766	JUNC00004510	1	-	46	30	-304.0	-304.0	-304.0
chrX	103918225	103918408	103918196	103918464	JUNC00004511	3	-	29	56	-304.0	-304.0	-304.0
chrX	103918460	103918659	103918408	103918717	JUNC00004512	3	-	52	58	-304.0	-304.0	-304.0
chrX	103918902	103919152	103918873	103919189	JUNC00004513	1	-	29	37	-304.0	-304.0	-304.0
chrX	103919080	103919424	103919047	103919488	JUNC00004514	2	-	33	64	-304.0	-304.0	-304.0
chrX	103919292	103919758	103919237	103919779	JUNC00004516	1	+	55	21	-304.0	-304.0	-304.0
chrX	103919292	103928065	103919219	103928121	JUNC00004515	4	+	73	56	-304.0	-304.0	-304.0
chrX	103919292	103931015	103919263	103931077	JUNC00004518	4	+	29	62	-304.0	-304.0	-304.0
chrX	103919292	103962020	103919255	103962076	JUNC00004517	7	+	37	56	-304.0	-304.0	-304.0
chrX	103962723	103964227	103962669	103964281	JUNC00004520	3	+	54	54	-304.0	-304.0	-304.0
chrX	103962723	103964505	103962651	103964579	JUNC00004519	43	+	72	74	-304.0	-304.0	-304.0
chrX	103964622	103965538	103964547	103965611	JUNC00004521	37	+	75	73	-304.0	-304.0	-304.0
chrX	103972729	103975874	103972691	103975912	JUNC00004522	1	+	38	38	-304.0	-304.0	-304.0
chrX	103976301	103976626	103976264	103976665	JUNC00004524	1	+	37	39	-304.0	-304.0	-304.0
chrX	103976301	103976724	103976240	103976783	JUNC00004523	14	+	61	59	-304.0	-304.0	-304.0
chrX	103976783	103976983	103976723	103977058	JUNC00004525	15	+	60	75	-304.0	-304.0	-304.0
chrX	103977179	103978011	103977120	103978070	JUNC00004526	11	+	59	59	-304.0	-304.0	-304.0
chrX	103977189	103978011	103977168	103978066	JUNC00004527	1	+	21	55	-304.0	-304.0	-304.0
chrX	104060849	104061672	104060794	104061693	JUNC00004529	1	-	55	21	-304.0	-304.0	-304.0
chrX	104060849	104061682	104060775	104061741	JUNC00004528	13	-	74	59	-304.0	-304.0	-304.0
chrX	104061878	104062078	104061803	104062138	JUNC00004530	15	-	75	60	-304.0	-304.0	-304.0
chrX	104062137	104062560	104062078	104062635	JUNC00004531	15	-	59	75	-304.0	-304.0	-304.0
chrX	104062987	104066133	104062949	104066171	JUNC00004533	1	-	38	38	-304.0	-304.0	-304.0
chrX	104062987	104072049	104062936	104072074	JUNC00004532	1	-	51	25	-304.0	-304.0	-304.0
chrX	104065984	104066133	104065959	104066181	JUNC00004535	1	-	25	48	-304.0	-304.0	-304.0
chrX	104065984	104074240	104065912	104074314	JUNC00004534	15	-	72	74	-304.0	-304.0	-304.0
chrX	104074357	104076139	104074283	104076209	JUNC00004536	40	-	74	70	-304.0	-304.0	-304.0
chrX	104074635	104076139	104074581	104076193	JUNC00004537	3	-	54	54	-304.0	-304.0	-304.0
chrX	104105288	104111307	104105213	104111370	JUNC00004538	5	-	75	63	-304.0	-304.0	-304.0
chrX	104105288	104112315	104105232	104112369	JUNC00004539	2	-	56	54	-304.0	-304.0	-304.0
chrX	104106299	104111307	104106254	104111338	JUNC00004540	1	-	45	31	-304.0	-304.0	-304.0
chrX	104106299	104111403	104106278	104111458	JUNC00004541	1	-	21	55	-304.0	-304.0	-304.0
chrX	104111473	104112315	104111413	104112363	JUNC00004542	2	-	60	48	-304.0	-304.0	-304.0
chrX	104113001	104113194	104112926	104113246	JUNC00004543	4	+	75	52	-304.0	-304.0	-304.0
chrX	104113246	104113433	104113194	104113500	JUNC00004544	3	+	52	67	-304.0	-304.0	-304.0
chrX	104113573	104115251	104113501	104115314	JUNC00004545	5	+	72	63	-304.0	-304.0	-304.0
chrX	104131223	104131847	104131202	104131902	JUNC00004548	1	-	21	55	-304.0	-304.0	-304.0
chrX	104131223	104155740	104131202	104155795	JUNC00004547	1	-	21	55	-304.0	-304.0	-304.0
chrX	104131223	104156877	104131172	104156934	JUNC00004546	3	-	51	57	-304.0	-304.0	-304.0
chrX	104166982	104175622	104166914	104175695	JUNC00004549	15	+	68	73	-304.0	-304.0	-304.0
chrX	104175842	104186065	104175769	104186136	JUNC00004550	54	+	73	71	-304.0	-304.0	-304.0
chrX	104186215	104186459	104186142	104186524	JUNC00004551	61	+	73	65	-304.0	-304.0	-304.0
chrX	104186621	104188039	104186546	104188112	JUNC00004552	41	+	75	73	-304.0	-304.0	-304.0
chrX	104188306	104189607	104188234	104189682	JUNC00004553	80	+	72	75	-304.0	-304.0	-304.0
chrX	105717433	105725357	105717384	105725384	JUNC00004554	1	-	49	27	-304.0	-304.0	-304.0
chrX	106612087	106622650	106612048	106622687	JUNC00004555	1	+	39	37	-304.0	-304.0	-304.0
chrX	106612723	106622650	106612650	106622724	JUNC00004556	17	+	73	74	-304.0	-304.0	-304.0
chrX	106622793	106625089	106622719	106625156	JUNC00004557	12	+	74	67	-304.0	-304.0	-304.0
chrX	106625282	106632624	106625213	106632673	JUNC00004558	16	+	69	49	-304.0	-304.0	-304.0
chrX	106632733	106632931	106632658	106633003	JUNC00004559	19	+	75	72	-304.0	-304.0	-304.0
chrX	106633023	106633129	106632957	106633196	JUNC00004560	12	+	66	67	-304.0	-304.0	-304.0
chrX	106633252	106636542	106633184	106636615	JUNC00004561	8	+	68	73	-304.0	-304.0	-304.0
chrX	106636647	106637759	106636576	106637823	JUNC00004562	16	+	71	64	-304.0	-304.0	-304.0
chrX	106637794	106640551	106637759	106640623	JUNC00004563	6	+	35	72	-304.0	-304.0	-304.0
chrX	106637924	106639526	106637853	106639601	JUNC00004564	8	+	71	75	-304.0	-304.0	-304.0
chrX	106639687	106640551	106639614	106640618	JUNC00004565	10	+	73	67	-304.0	-304.0	-304.0
chrX	106640721	106648312	106640662	106648379	JUNC00004566	21	+	59	67	-304.0	-304.0	-304.0
chrX	106648386	106662014	106648315	106662089	JUNC00004567	24	+	71	75	-304.0	-304.0	-304.0
chrX	106662305	106669162	106662231	106669234	JUNC00004568	35	+	74	72	-304.0	-304.0	-304.0
chrX	106669330	106678127	106669255	106678199	JUNC00004569	24	+	75	72	-304.0	-304.0	-304.0
chrX	106818773	106820876	106818712	106820945	JUNC00004570	7	+	61	69	-304.0	-304.0	-304.0
chrX	106820995	106821976	106820934	106822003	JUNC00004571	3	+	61	27	-304.0	-304.0	-304.0
chrX	106822202	106823225	106822132	106823272	JUNC00004572	2	+	70	47	-304.0	-304.0	-304.0
chrX	106823466	106826029	106823403	106826088	JUNC00004573	5	+	63	59	-304.0	-304.0	-304.0
chrX	106826237	106827169	106826190	106827230	JUNC00004574	4	+	47	61	-304.0	-304.0	-304.0
chrX	106827337	106839307	106827303	106839373	JUNC00004575	6	+	34	66	-304.0	-304.0	-304.0
chrX	106839457	106840047	106839383	106840115	JUNC00004576	9	+	74	68	-304.0	-304.0	-304.0
chrX	106840198	106840669	106840126	106840722	JUNC00004577	8	+	72	53	-304.0	-304.0	-304.0
chrX	106840884	106848185	106840829	106848232	JUNC00004578	4	+	55	47	-304.0	-304.0	-304.0
chrX	106848303	106850024	106848233	106850083	JUNC00004579	2	+	70	59	-304.0	-304.0	-304.0
chrX	106849478	106850024	106849421	106850043	JUNC00004580	1	+	57	19	-304.0	-304.0	-304.0
chrX	106850310	106853520	106850291	106853577	JUNC00004581	1	+	19	57	-304.0	-304.0	-304.0
chrX	106853650	106854197	106853627	106854250	JUNC00004582	1	+	23	53	-304.0	-304.0	-304.0
chrX	106854296	106865558	106854246	106865614	JUNC00004583	3	+	50	56	-304.0	-304.0	-304.0
chrX	106865627	106865792	106865559	106865861	JUNC00004584	8	+	68	69	-304.0	-304.0	-304.0
chrX	106866033	106866796	106866012	106866851	JUNC00004585	1	+	21	55	-304.0	-304.0	-304.0
chrX	106866862	106868392	106866810	106868465	JUNC00004586	3	+	52	73	-304.0	-304.0	-304.0
chrX	106868476	106869484	106868412	106869542	JUNC00004587	8	+	64	58	-304.0	-304.0	-304.0
chrX	106869541	106870715	106869489	106870747	JUNC00004588	2	+	52	32	-304.0	-304.0	-304.0
chrX	106870813	106873569	106870763	106873643	JUNC00004589	7	+	50	74	-304.0	-304.0	-304.0
chrX	106941632	106941937	106941592	106941973	JUNC00004590	1	-	40	36	-304.0	-304.0	-304.0
chrX	106942221	106942514	106942165	106942534	JUNC00004591	1	-	56	20	-304.0	-304.0	-304.0
chrX	106943205	106954912	106943146	106954933	JUNC00004592	2	-	59	21	-304.0	-304.0	-304.0
chrX	106955088	106956479	106955013	106956529	JUNC00004593	7	-	75	50	-304.0	-304.0	-304.0
chrX	106956534	106956935	106956505	106957004	JUNC00004594	4	-	29	69	-304.0	-304.0	-304.0
chrX	106957004	106958335	106956958	106958392	JUNC00004595	2	-	46	57	-304.0	-304.0	-304.0
chrX	106958464	106962011	106958397	106962063	JUNC00004596	3	-	67	52	-304.0	-304.0	-304.0
chrX	106978199	106980890	106978146	106980934	JUNC00004597	2	-	53	44	-304.0	-304.0	-304.0
chrX	106981019	106981344	106981000	106981401	JUNC00004598	1	-	19	57	-304.0	-304.0	-304.0
chrX	106981477	106985095	106981458	106985152	JUNC00004600	1	-	19	57	-304.0	-304.0	-304.0
chrX	106981477	106993229	106981424	106993252	JUNC00004599	1	-	53	23	-304.0	-304.0	-304.0
chrX	106993362	106999676	106993291	106999717	JUNC00004601	4	-	71	41	-304.0	-304.0	-304.0
chrX	107067693	107069254	107067628	107069328	JUNC00004602	25	-	65	74	-304.0	-304.0	-304.0
chrX	107069330	107088435	107069276	107088457	JUNC00004603	1	-	54	22	-304.0	-304.0	-304.0
chrX	107069402	107088435	107069327	107088503	JUNC00004604	22	-	75	68	-304.0	-304.0	-304.0
chrX	107088839	107115351	107088767	107115411	JUNC00004605	13	-	72	60	-304.0	-304.0	-304.0
chrX	107113468	107115351	107113396	107115426	JUNC00004606	17	-	72	75	-304.0	-304.0	-304.0
chrX	107115556	107115861	107115483	107115935	JUNC00004607	36	-	73	74	-304.0	-304.0	-304.0
chrX	107116054	107116150	107116016	107116188	JUNC00004609	1	-	38	38	-304.0	-304.0	-304.0
chrX	107116054	107116649	107115981	107116723	JUNC00004608	41	-	73	74	-304.0	-304.0	-304.0
chrX	107116766	107118765	107116693	107118813	JUNC00004610	13	-	73	48	-304.0	-304.0	-304.0
chrX	107118802	107118987	107118747	107119008	JUNC00004611	1	+	55	21	-304.0	-304.0	-304.0
chrX	107124332	107147742	107124265	107147756	JUNC00004612	3	-	67	14	-304.0	-304.0	-304.0
chrX	107147809	107150855	107147791	107150913	JUNC00004613	1	-	18	58	-304.0	-304.0	-304.0
chrX	107153306	107153453	107153240	107153463	JUNC00004614	1	-	66	10	-304.0	-304.0	-304.0
chrX	107153503	107154095	107153456	107154169	JUNC00004615	3	-	47	74	-304.0	-304.0	-304.0
chrX	107154246	107167648	107154208	107167686	JUNC00004616	1	-	38	38	-304.0	-304.0	-304.0
chrX	107167784	107175088	107167747	107175154	JUNC00004617	4	-	37	66	-304.0	-304.0	-304.0
chrX	107175193	107206272	107175142	107206300	JUNC00004618	2	-	51	28	-304.0	-304.0	-304.0
chrX	107517541	107543597	107517512	107543644	JUNC00004619	1	-	29	47	-304.0	-304.0	-304.0
chrX	107597361	107677358	107597320	107677393	JUNC00004620	1	-	41	35	-304.0	-304.0	-304.0
chrX	107606253	107665780	107606232	107665835	JUNC00004621	1	+	21	55	-304.0	-304.0	-304.0
chrX	107628066	107628939	107628030	107628979	JUNC00004622	1	-	36	40	-304.0	-304.0	-304.0
chrX	107628750	107639294	107628676	107639369	JUNC00004623	194	+	74	75	-304.0	-304.0	-304.0
chrX	107628750	107640901	107628682	107640955	JUNC00004624	2	+	68	54	-304.0	-304.0	-304.0
chrX	107639478	107640901	107639404	107640976	JUNC00004625	164	+	74	75	-304.0	-304.0	-304.0
chrX	107641000	107642365	107640925	107642434	JUNC00004626	120	+	75	69	-304.0	-304.0	-304.0
chrX	107642490	107645176	107642415	107645251	JUNC00004627	231	+	75	75	-304.0	-304.0	-304.0
chrX	107645350	107647605	107645276	107647680	JUNC00004628	180	+	74	75	-304.0	-304.0	-304.0
chrX	107647765	107649939	107647690	107650014	JUNC00004629	153	+	75	75	-304.0	-304.0	-304.0
chrX	107714749	107715898	107714676	107715950	JUNC00004630	118	-	73	52	-304.0	-304.0	-304.0
chrX	107715950	107716689	107715881	107716763	JUNC00004631	123	-	69	74	-304.0	-304.0	-304.0
chrX	107715950	107775099	107715923	107775148	JUNC00004632	1	-	27	49	-304.0	-304.0	-304.0
chrX	107854704	107903957	107854649	107903978	JUNC00004633	1	+	55	21	-304.0	-304.0	-304.0
chrX	108085127	108087685	108085053	108087760	JUNC00004634	174	-	74	75	-304.0	-304.0	-304.0
chrX	108085127	108087698	108085072	108087721	JUNC00004636	2	-	55	23	-304.0	-304.0	-304.0
chrX	108085127	108087764	108085057	108087836	JUNC00004635	21	-	70	72	-304.0	-304.0	-304.0
chrX	108087852	108087952	108087777	108088024	JUNC00004637	156	-	75	72	-304.0	-304.0	-304.0
chrX	108088095	108088751	108088047	108088826	JUNC00004639	2	-	48	75	-304.0	-304.0	-304.0
chrX	108088099	108088751	108088024	108088826	JUNC00004638	176	-	75	75	-304.0	-304.0	-304.0
chrX	108088099	108091406	108088083	108091466	JUNC00004640	1	-	16	60	-304.0	-304.0	-304.0
chrX	108088850	108091406	108088775	108091479	JUNC00004641	171	-	75	73	-304.0	-304.0	-304.0
chrX	108091836	108126076	108091764	108126147	JUNC00004642	37	+	72	71	-304.0	-304.0	-304.0
chrX	108100528	108126076	108100488	108126146	JUNC00004643	2	+	40	70	-304.0	-304.0	-304.0
chrX	108126187	108126792	108126133	108126855	JUNC00004645	3	+	54	63	-304.0	-304.0	-304.0
chrX	108126187	108128780	108126114	108128852	JUNC00004644	41	+	73	72	-304.0	-304.0	-304.0
chrX	108128852	108131259	108128779	108131332	JUNC00004646	46	+	73	73	-304.0	-304.0	-304.0
chrX	108131358	108134056	108131284	108134131	JUNC00004647	41	+	74	75	-304.0	-304.0	-304.0
chrX	108134158	108134338	108134089	108134411	JUNC00004648	54	+	69	73	-304.0	-304.0	-304.0
chrX	108134411	108137090	108134337	108137164	JUNC00004649	54	+	74	74	-304.0	-304.0	-304.0
chrX	108137170	108137803	108137097	108137878	JUNC00004650	35	+	73	75	-304.0	-304.0	-304.0
chrX	108137884	108150151	108137826	108150208	JUNC00004651	3	+	58	57	-304.0	-304.0	-304.0
chrX	108137991	108138112	108137916	108138184	JUNC00004652	37	+	75	72	-304.0	-304.0	-304.0
chrX	108138077	108150151	108138014	108150176	JUNC00004653	2	+	63	25	-304.0	-304.0	-304.0
chrX	108138191	108150151	108138116	108150225	JUNC00004654	34	+	75	74	-304.0	-304.0	-304.0
chrX	108150297	108151801	108150226	108151858	JUNC00004655	43	+	71	57	-304.0	-304.0	-304.0
chrX	108151858	108152978	108151800	108153053	JUNC00004656	42	+	58	75	-304.0	-304.0	-304.0
chrX	108153087	108153641	108153017	108153709	JUNC00004657	46	+	70	68	-304.0	-304.0	-304.0
chrX	108440206	108440340	108440163	108440373	JUNC00004659	1	+	43	33	-304.0	-304.0	-304.0
chrX	108440206	108539745	108440133	108539779	JUNC00004658	4	+	73	34	-304.0	-304.0	-304.0
chrX	108559153	108563881	108559095	108563899	JUNC00004660	1	+	58	18	-304.0	-304.0	-304.0
chrX	108563926	108568628	108563882	108568660	JUNC00004661	1	+	44	32	-304.0	-304.0	-304.0
chrX	108568673	108568758	108568628	108568775	JUNC00004662	1	+	45	17	-304.0	-304.0	-304.0
chrX	108568821	108571412	108568775	108571466	JUNC00004663	2	+	46	54	-304.0	-304.0	-304.0
chrX	108571466	108571810	108571412	108571837	JUNC00004664	2	+	54	27	-304.0	-304.0	-304.0
chrX	108571837	108573573	108571810	108573604	JUNC00004665	1	+	27	31	-304.0	-304.0	-304.0
chrX	108575972	108577951	108575924	108577979	JUNC00004666	1	+	48	28	-304.0	-304.0	-304.0
chrX	108577987	108578077	108577956	108578120	JUNC00004667	1	+	31	43	-304.0	-304.0	-304.0
chrX	108578119	108578290	108578091	108578338	JUNC00004668	1	+	28	48	-304.0	-304.0	-304.0
chrX	108580586	108580681	108580539	108580723	JUNC00004669	2	+	47	42	-304.0	-304.0	-304.0
chrX	108582937	108584483	108582917	108584529	JUNC00004670	1	+	20	46	-304.0	-304.0	-304.0
chrX	108584525	108586614	108584497	108586674	JUNC00004671	2	+	28	60	-304.0	-304.0	-304.0
chrX	108595601	108596997	108595572	108597046	JUNC00004672	2	+	29	49	-304.0	-304.0	-304.0
chrX	108597568	108598701	108597497	108598719	JUNC00004673	3	+	71	18	-304.0	-304.0	-304.0
chrX	108606892	108614910	108606835	108614930	JUNC00004674	2	+	57	20	-304.0	-304.0	-304.0
chrX	108615024	108620258	108614985	108620311	JUNC00004675	2	+	39	53	-304.0	-304.0	-304.0
chrX	108620426	108621802	108620394	108621846	JUNC00004676	1	+	32	44	-304.0	-304.0	-304.0
chrX	108625794	108626209	108625727	108626276	JUNC00004677	4	+	67	67	-304.0	-304.0	-304.0
chrX	108655457	108665506	108655390	108665581	JUNC00004678	3	+	67	75	-304.0	-304.0	-304.0
chrX	108665587	108666495	108665517	108666552	JUNC00004679	4	+	70	57	-304.0	-304.0	-304.0
chrX	108667183	108668318	108667155	108668366	JUNC00004680	1	+	28	48	-304.0	-304.0	-304.0
chrX	108680751	108680884	108680730	108680939	JUNC00004681	1	+	21	55	-304.0	-304.0	-304.0
chrX	108681888	108686030	108681814	108686077	JUNC00004682	3	+	74	47	-304.0	-304.0	-304.0
chrX	108686129	108687481	108686098	108687526	JUNC00004683	1	+	31	45	-304.0	-304.0	-304.0
chrX	108692925	108694806	108692884	108694848	JUNC00004684	2	+	41	42	-304.0	-304.0	-304.0
chrX	109537021	109538044	109536946	109538119	JUNC00004685	21	+	75	75	-304.0	-304.0	-304.0
chrX	109537270	109538044	109537208	109538119	JUNC00004686	23	+	62	75	-304.0	-304.0	-304.0
chrX	109537542	109538044	109537495	109538073	JUNC00004687	1	+	47	29	-304.0	-304.0	-304.0
chrX	109538131	109541474	109538056	109541548	JUNC00004688	55	+	75	74	-304.0	-304.0	-304.0
chrX	109541619	109542506	109541544	109542581	JUNC00004689	55	+	75	75	-304.0	-304.0	-304.0
chrX	109624321	109659353	109624271	109659379	JUNC00004690	1	-	50	26	-304.0	-304.0	-304.0
chrX	109629579	109644044	109629559	109644100	JUNC00004691	1	-	20	56	-304.0	-304.0	-304.0
chrX	109632850	109644044	109632808	109644078	JUNC00004692	1	-	42	34	-304.0	-304.0	-304.0
chrX	109644186	109659353	109644111	109659428	JUNC00004693	129	-	75	75	-304.0	-304.0	-304.0
chrX	109644186	109661530	109644152	109661602	JUNC00004694	2	-	34	72	-304.0	-304.0	-304.0
chrX	109659511	109661530	109659436	109661605	JUNC00004695	192	-	75	75	-304.0	-304.0	-304.0
chrX	109661645	109663210	109661571	109663285	JUNC00004696	139	-	74	75	-304.0	-304.0	-304.0
chrX	109663402	109665419	109663327	109665493	JUNC00004697	170	-	75	74	-304.0	-304.0	-304.0
chrX	109665494	109668100	109665419	109668173	JUNC00004698	197	-	75	73	-304.0	-304.0	-304.0
chrX	109668273	109669033	109668198	109669106	JUNC00004699	102	-	75	73	-304.0	-304.0	-304.0
chrX	109669173	109674401	109669099	109674475	JUNC00004700	157	-	74	74	-304.0	-304.0	-304.0
chrX	109674473	109677987	109674400	109678062	JUNC00004701	169	-	73	75	-304.0	-304.0	-304.0
chrX	109678111	109678264	109678036	109678339	JUNC00004702	164	-	75	75	-304.0	-304.0	-304.0
chrX	109678415	109680997	109678340	109681072	JUNC00004703	148	-	75	75	-304.0	-304.0	-304.0
chrX	109681136	109681265	109681064	109681340	JUNC00004704	132	-	72	75	-304.0	-304.0	-304.0
chrX	109681375	109682718	109681301	109682792	JUNC00004705	96	-	74	74	-304.0	-304.0	-304.0
chrX	109682896	109683135	109682821	109683209	JUNC00004706	127	-	75	74	-304.0	-304.0	-304.0
chrX	109682896	109696143	109682878	109696196	JUNC00004707	1	-	18	53	-304.0	-304.0	-304.0
chrX	109683372	109696143	109683305	109696197	JUNC00004711	18	-	67	54	-304.0	-304.0	-304.0
chrX	109683375	109691002	109683302	109691040	JUNC00004710	2	-	73	38	-304.0	-304.0	-304.0
chrX	109683375	109696143	109683302	109696196	JUNC00004709	51	-	73	53	-304.0	-304.0	-304.0
chrX	109683375	109733138	109683309	109733193	JUNC00004712	10	-	66	55	-304.0	-304.0	-304.0
chrX	109683666	109696143	109683606	109696196	JUNC00004713	2	-	60	53	-304.0	-304.0	-304.0
chrX	109696196	109733138	109696143	109733212	JUNC00004708	48	-	53	74	-304.0	-304.0	-304.0
chrX	109924274	109941283	109924235	109941320	JUNC00004714	1	-	39	37	-304.0	-304.0	-304.0
chrX	109995724	110027689	109995690	110027731	JUNC00004715	1	+	34	42	-304.0	-304.0	-304.0
chrX	110002772	110067346	110002742	110067396	JUNC00004716	6	+	30	50	-304.0	-304.0	-304.0
chrX	110003178	110003500	110003106	110003571	JUNC00004718	10	+	72	71	-304.0	-304.0	-304.0
chrX	110004164	110067346	110004092	110067397	JUNC00004719	27	+	72	51	-304.0	-304.0	-304.0
chrX	110046484	110067346	110046420	110067396	JUNC00004720	3	+	64	50	-304.0	-304.0	-304.0
chrX	110067396	110109079	110067346	110109146	JUNC00004717	40	+	50	67	-304.0	-304.0	-304.0
chrX	110109146	110144797	110109079	110144865	JUNC00004721	30	+	67	68	-304.0	-304.0	-304.0
chrX	110144876	110171419	110144803	110171487	JUNC00004722	35	+	73	68	-304.0	-304.0	-304.0
chrX	110171520	110173244	110171446	110173318	JUNC00004723	30	+	74	74	-304.0	-304.0	-304.0
chrX	110173453	110182305	110173405	110182341	JUNC00004724	2	+	48	36	-304.0	-304.0	-304.0
chrX	110198634	110200953	110198561	110201028	JUNC00004725	16	-	73	75	-304.0	-304.0	-304.0
chrX	110201050	110202445	110200977	110202518	JUNC00004726	23	-	73	73	-304.0	-304.0	-304.0
chrX	110202536	110216517	110202461	110216590	JUNC00004727	29	-	75	73	-304.0	-304.0	-304.0
chrX	110216632	110264488	110216557	110264549	JUNC00004728	22	-	75	61	-304.0	-304.0	-304.0
chrX	110216632	110317598	110216578	110317620	JUNC00004729	2	-	54	22	-304.0	-304.0	-304.0
chrX	110264599	110317598	110264543	110317670	JUNC00004730	23	-	56	72	-304.0	-304.0	-304.0
chrX	110309537	110317598	110309492	110317651	JUNC00004731	3	-	45	53	-304.0	-304.0	-304.0
chrX	110443143	110445114	110443096	110445143	JUNC00004732	1	+	47	29	-304.0	-304.0	-304.0
chrX	110454664	110455201	110454628	110455241	JUNC00004733	1	+	36	40	-304.0	-304.0	-304.0
chrX	110676361	110679335	110676331	110679381	JUNC00004734	1	-	30	46	-304.0	-304.0	-304.0
chrX	110679425	110681481	110679387	110681519	JUNC00004735	1	-	38	38	-304.0	-304.0	-304.0
chrX	110719928	110721384	110719909	110721441	JUNC00004736	1	-	19	57	-304.0	-304.0	-304.0
chrX	110721530	110759660	110721455	110759680	JUNC00004737	3	-	75	20	-304.0	-304.0	-304.0
chrX	110784280	110792087	110784240	110792123	JUNC00004738	1	-	40	36	-304.0	-304.0	-304.0
chrX	111512094	111518074	111512083	111518139	JUNC00004739	1	+	11	65	-304.0	-304.0	-304.0
chrX	111619990	111620094	111619918	111620132	JUNC00004740	4	-	72	38	-304.0	-304.0	-304.0
chrX	111621066	111621154	111621019	111621183	JUNC00004741	1	?	47	29	-304.0	-304.0	-304.0
chrX	111622995	111636844	111622979	111636900	JUNC00004742	1	-	16	56	112.0	-304.0	112.0
chrX	111681299	111682131	111681225	111682205	JUNC00004744	44	+	74	74	-304.0	-304.0	-304.0
chrX	111681299	111682235	111681224	111682291	JUNC00004743	8	+	75	56	-304.0	-304.0	-304.0
chrX	111681424	111682131	111681360	111682198	JUNC00004745	4	+	64	67	-304.0	-304.0	-304.0
chrX	111681424	111682235	111681382	111682294	JUNC00004746	2	+	42	59	-304.0	-304.0	-304.0
chrX	111682294	111684964	111682219	111685035	JUNC00004747	86	+	75	71	-304.0	-304.0	-304.0
chrX	111685103	111686136	111685046	111686174	JUNC00004749	5	+	57	38	-304.0	-304.0	-304.0
chrX	111685103	111708026	111685042	111708090	JUNC00004748	10	+	61	64	-304.0	-304.0	-304.0
chrX	111685103	111708964	111685061	111708998	JUNC00004750	1	+	42	34	-304.0	-304.0	-304.0
chrX	111686174	111687886	111686136	111687961	JUNC00004751	15	+	38	75	-304.0	-304.0	-304.0
chrX	111688048	111689086	111688027	111689141	JUNC00004752	1	+	21	55	-304.0	-304.0	-304.0
chrX	111689197	111717845	111689173	111717897	JUNC00004753	1	+	24	52	-304.0	-304.0	-304.0
chrX	111708393	111708964	111708325	111709034	JUNC00004754	9	+	68	70	-304.0	-304.0	-304.0
chrX	111709048	111711674	111708974	111711726	JUNC00004755	11	+	74	52	-304.0	-304.0	-304.0
chrX	111711725	111712483	111711674	111712530	JUNC00004756	8	+	51	47	-304.0	-304.0	-304.0
chrX	111712530	111713224	111712481	111713297	JUNC00004757	16	+	49	73	-304.0	-304.0	-304.0
chrX	111713297	111717845	111713225	111717917	JUNC00004758	14	+	72	72	-304.0	-304.0	-304.0
chrX	111717004	111717845	111716962	111717879	JUNC00004759	1	+	42	34	-304.0	-304.0	-304.0
chrX	111717927	111718111	111717859	111718183	JUNC00004760	23	+	68	72	-304.0	-304.0	-304.0
chrX	111718274	111720094	111718206	111720155	JUNC00004761	23	+	68	61	-304.0	-304.0	-304.0
chrX	111720170	111721602	111720096	111721677	JUNC00004762	24	+	74	75	-304.0	-304.0	-304.0
chrX	111721711	111722792	111721636	111722860	JUNC00004763	27	+	75	68	-304.0	-304.0	-304.0
chrX	111721711	111723797	111721680	111723842	JUNC00004764	1	+	31	45	-304.0	-304.0	-304.0
chrX	111722857	111723797	111722790	111723867	JUNC00004765	18	+	67	70	-304.0	-304.0	-304.0
chrX	111723898	111724933	111723824	111725004	JUNC00004766	16	+	74	71	-304.0	-304.0	-304.0
chrX	111725061	111726808	111724988	111726883	JUNC00004767	21	+	73	75	-304.0	-304.0	-304.0
chrX	111727055	111727331	111726987	111727406	JUNC00004768	24	+	68	75	-304.0	-304.0	-304.0
chrX	111727445	111727613	111727372	111727685	JUNC00004769	27	+	73	72	-304.0	-304.0	-304.0
chrX	111727770	111728184	111727696	111728242	JUNC00004770	20	+	74	58	-304.0	-304.0	-304.0
chrX	111728305	111730394	111728231	111730427	JUNC00004771	24	+	74	33	-304.0	-304.0	-304.0
chrX	111730427	111730524	111730394	111730581	JUNC00004772	21	+	33	57	-304.0	-304.0	-304.0
chrX	111730580	111735050	111730524	111735122	JUNC00004773	17	+	56	72	-304.0	-304.0	-304.0
chrX	111730580	111735089	111730524	111735122	JUNC00004774	4	+	56	33	-304.0	-304.0	-304.0
chrX	111735122	111736713	111735053	111736786	JUNC00004775	15	+	69	73	-304.0	-304.0	-304.0
chrX	111736879	111744667	111736809	111744730	JUNC00004776	14	+	70	63	-304.0	-304.0	-304.0
chrX	111744904	111747887	111744829	111747911	JUNC00004778	3	+	75	24	-304.0	-304.0	-304.0
chrX	111744904	111752789	111744829	111752830	JUNC00004777	19	+	75	41	-304.0	-304.0	-304.0
chrX	111752830	111757587	111752789	111757656	JUNC00004779	16	+	41	69	-304.0	-304.0	-304.0
chrX	111752830	111757632	111752789	111757705	JUNC00004780	3	+	41	73	-304.0	-304.0	-304.0
chrX	111757762	111759733	111757692	111759808	JUNC00004781	24	+	70	75	-304.0	-304.0	-304.0
chrX	111757762	111764509	111757730	111764553	JUNC00004782	1	+	32	44	-304.0	-304.0	-304.0
chrX	111757931	111759733	111757873	111759808	JUNC00004783	2	+	58	75	-304.0	-304.0	-304.0
chrX	111759991	111764509	111759947	111764541	JUNC00004784	1	+	44	32	-304.0	-304.0	-304.0
chrX	112631601	112660626	112631547	112660663	JUNC00004785	3	-	54	37	-304.0	-304.0	-304.0
chrX	112648713	112660626	112648685	112660674	JUNC00004786	1	-	28	48	-304.0	-304.0	-304.0
chrX	112648713	112671008	112648696	112671067	JUNC00004787	1	-	17	59	-304.0	-304.0	-304.0
chrX	112660725	112671008	112660651	112671081	JUNC00004788	11	-	74	73	-304.0	-304.0	-304.0
chrX	112671404	112676364	112671347	112676383	JUNC00004790	1	-	57	19	-304.0	-304.0	-304.0
chrX	112671404	112679828	112671330	112679861	JUNC00004789	5	-	74	33	-304.0	-304.0	-304.0
chrX	112671842	112679828	112671767	112679879	JUNC00004791	3	-	75	51	-304.0	-304.0	-304.0
chrX	112676489	112679828	112676434	112679849	JUNC00004792	1	-	55	21	-304.0	-304.0	-304.0
chrX	112778664	112778996	112778589	112779065	JUNC00004793	15	-	75	69	-304.0	-304.0	-304.0
chrX	112779680	112780885	112779609	112780958	JUNC00004794	20	-	71	73	-304.0	-304.0	-304.0
chrX	112781118	112782539	112781049	112782606	JUNC00004795	9	-	69	67	-304.0	-304.0	-304.0
chrX	112782662	112790591	112782588	112790663	JUNC00004796	12	-	74	72	-304.0	-304.0	-304.0
chrX	112790782	112791831	112790722	112791904	JUNC00004797	19	-	60	73	-304.0	-304.0	-304.0
chrX	112791981	112804946	112791910	112805021	JUNC00004798	42	-	71	75	-304.0	-304.0	-304.0
chrX	112805092	112809893	112805031	112809956	JUNC00004799	14	-	61	63	-304.0	-304.0	-304.0
chrX	112809986	112811248	112809923	112811321	JUNC00004800	12	-	63	73	-304.0	-304.0	-304.0
chrX	112811393	112815357	112811331	112815430	JUNC00004801	14	-	62	73	-304.0	-304.0	-304.0
chrX	112815877	112822254	112815802	112822326	JUNC00004803	11	-	75	72	-304.0	-304.0	-304.0
chrX	112815877	112832293	112815802	112832338	JUNC00004802	5	-	75	45	-304.0	-304.0	-304.0
chrX	112823188	112825071	112823123	112825141	JUNC00004804	8	-	65	70	-304.0	-304.0	-304.0
chrX	112825220	112832293	112825149	112832340	JUNC00004805	6	-	71	47	-304.0	-304.0	-304.0
chrX	112832370	112840451	112832302	112840525	JUNC00004806	6	-	68	74	-304.0	-304.0	-304.0
chrX	112840315	112840451	112840300	112840512	JUNC00004807	1	-	15	61	-304.0	-304.0	-304.0
chrX	112876233	112882302	112876186	112882331	JUNC00004808	1	+	47	29	-304.0	-304.0	-304.0
chrX	112882420	112899277	112882366	112899299	JUNC00004809	1	+	54	22	-304.0	-304.0	-304.0
chrX	113943764	114046252	113943720	114046284	JUNC00004810	1	+	44	32	-304.0	-304.0	-304.0
chrX	114104586	114149111	114104558	114149157	JUNC00004811	1	+	28	46	-304.0	-304.0	-304.0
chrX	115149943	115150021	115149896	115150050	JUNC00004812	1	-	47	29	-304.0	-304.0	-304.0
chrX	115463290	115552158	115463255	115552198	JUNC00004813	1	-	35	40	-304.0	-304.0	-304.0
chrX	115561260	115610242	115561195	115610312	JUNC00004814	17	+	65	70	-304.0	-304.0	-304.0
chrX	115587520	115676074	115587486	115676116	JUNC00004815	1	+	34	42	-304.0	-304.0	-304.0
chrX	115610323	115622245	115610259	115622318	JUNC00004816	16	+	64	73	-304.0	-304.0	-304.0
chrX	115622409	115629197	115622335	115629265	JUNC00004817	19	+	74	68	-304.0	-304.0	-304.0
chrX	115629327	115629834	115629253	115629907	JUNC00004818	15	+	74	73	-304.0	-304.0	-304.0
chrX	115629967	115633999	115629897	115634073	JUNC00004819	22	+	70	74	-304.0	-304.0	-304.0
chrX	115634081	115634880	115634006	115634955	JUNC00004820	20	+	75	75	-304.0	-304.0	-304.0
chrX	115635046	115636835	115634973	115636907	JUNC00004821	38	+	73	72	-304.0	-304.0	-304.0
chrX	115636978	115640407	115636916	115640482	JUNC00004822	28	+	62	75	-304.0	-304.0	-304.0
chrX	115640503	115643312	115640431	115643382	JUNC00004823	24	+	72	70	-304.0	-304.0	-304.0
chrX	115643508	115645020	115643434	115645078	JUNC00004824	15	+	74	58	-304.0	-304.0	-304.0
chrX	115645099	115646071	115645034	115646136	JUNC00004825	23	+	65	65	-304.0	-304.0	-304.0
chrX	115646186	115646401	115646113	115646469	JUNC00004826	11	+	73	68	-304.0	-304.0	-304.0
chrX	115646535	115647549	115646463	115647620	JUNC00004827	24	+	72	71	-304.0	-304.0	-304.0
chrX	115647673	115647892	115647600	115647967	JUNC00004828	22	+	73	75	-304.0	-304.0	-304.0
chrX	115648017	115649428	115647945	115649493	JUNC00004829	43	+	72	65	-304.0	-304.0	-304.0
chrX	115671426	115671668	115671401	115671719	JUNC00004830	1	+	25	51	-304.0	-304.0	-304.0
chrX	115703673	115703707	115703639	115703748	JUNC00004831	1	+	34	41	-304.0	-304.0	-304.0
chrX	115727055	115730017	115726982	115730068	JUNC00004832	3	+	73	51	152.0	152.0	152.0
chrX	115727160	115730122	115727095	115730188	JUNC00004833	6	+	65	66	152.0	152.0	152.0
chrX	115844355	115847336	115844286	115847362	JUNC00004834	4	+	69	26	152.0	152.0	152.0
chrX	115844355	115850317	115844286	115850343	JUNC00004835	4	+	69	26	152.0	152.0	152.0
chrX	115845804	115848785	115845753	115848858	JUNC00004836	7	-	51	73	152.0	152.0	152.0
chrX	115847336	115850317	115847267	115850343	JUNC00004837	5	+	69	26	152.0	152.0	152.0
chrX	115848785	115854741	115848734	115854814	JUNC00004838	7	-	51	73	152.0	152.0	152.0
chrX	116011194	116011319	116011127	116011375	JUNC00004839	3	+	67	56	-304.0	-304.0	-304.0
chrX	116012470	116013025	116012446	116013077	JUNC00004840	1	+	24	52	-304.0	-304.0	-304.0
chrX	117899395	117901832	117899325	117901867	JUNC00004841	4	-	70	35	-304.0	-304.0	-304.0
chrX	117901946	117909300	117901888	117909318	JUNC00004842	1	-	58	18	-304.0	-304.0	-304.0
chrX	117910096	117919520	117910043	117919561	JUNC00004843	2	-	53	41	-304.0	-304.0	-304.0
chrX	117919717	117920237	117919682	117920311	JUNC00004844	3	-	35	74	-304.0	-304.0	-304.0
chrX	117920370	117945433	117920315	117945485	JUNC00004845	2	-	55	52	-304.0	-304.0	-304.0
chrX	117972843	117983479	117972797	117983509	JUNC00004846	1	-	46	30	-304.0	-304.0	-304.0
chrX	118346580	118378418	118346517	118378453	JUNC00004847	17	+	63	35	-304.0	-304.0	-304.0
chrX	118346580	118387339	118346553	118387392	JUNC00004849	2	+	27	53	-304.0	-304.0	-304.0
chrX	118378452	118387339	118378418	118387413	JUNC00004848	24	+	34	74	-304.0	-304.0	-304.0
chrX	118387414	118392631	118387339	118392705	JUNC00004850	24	+	75	74	-304.0	-304.0	-304.0
chrX	118394185	118395248	118394114	118395318	JUNC00004851	29	+	71	70	-304.0	-304.0	-304.0
chrX	118395344	118396969	118395271	118397044	JUNC00004852	23	+	73	75	-304.0	-304.0	-304.0
chrX	118397106	118398386	118397034	118398456	JUNC00004853	26	+	72	70	-304.0	-304.0	-304.0
chrX	118398470	118404337	118398397	118404412	JUNC00004854	27	+	73	75	-304.0	-304.0	-304.0
chrX	118402215	118407282	118402190	118407330	JUNC00004855	1	-	25	48	-304.0	-304.0	-304.0
chrX	118404444	118406874	118404374	118406942	JUNC00004856	16	+	70	68	-304.0	-304.0	-304.0
chrX	118407026	118409488	118406952	118409563	JUNC00004857	35	+	74	75	-304.0	-304.0	-304.0
chrX	118409627	118410894	118409557	118410964	JUNC00004858	42	+	70	70	-304.0	-304.0	-304.0
chrX	118410959	118432780	118410894	118432855	JUNC00004859	40	+	65	75	-304.0	-304.0	-304.0
chrX	118426010	118437971	118425983	118438020	JUNC00004860	1	+	27	49	-304.0	-304.0	-304.0
chrX	118427821	118818452	118427778	118818493	JUNC00004861	3	-	43	41	-304.0	-304.0	-304.0
chrX	118432894	118436701	118432819	118436772	JUNC00004862	28	+	75	71	-304.0	-304.0	-304.0
chrX	118436824	118441367	118436751	118441440	JUNC00004863	33	+	73	73	-304.0	-304.0	-304.0
chrX	118436824	118442243	118436780	118442275	JUNC00004864	1	+	44	32	-304.0	-304.0	-304.0
chrX	118441559	118442243	118441484	118442311	JUNC00004865	31	+	75	68	-304.0	-304.0	-304.0
chrX	118441559	118444359	118441533	118444409	JUNC00004866	1	+	26	50	-304.0	-304.0	-304.0
chrX	118442345	118442564	118442270	118442639	JUNC00004867	29	+	75	75	-304.0	-304.0	-304.0
chrX	118442680	118443559	118442614	118443631	JUNC00004868	20	+	66	72	-304.0	-304.0	-304.0
chrX	118443687	118444359	118443612	118444434	JUNC00004869	40	+	75	75	-304.0	-304.0	-304.0
chrX	118443687	118448892	118443665	118448946	JUNC00004870	1	+	22	54	-304.0	-304.0	-304.0
chrX	118444494	118448892	118444422	118448964	JUNC00004871	36	+	72	72	-304.0	-304.0	-304.0
chrX	118472208	118531700	118472179	118531745	JUNC00004872	1	+	29	45	-304.0	-304.0	-304.0
chrX	118496073	118542724	118496015	118542787	JUNC00004873	11	+	58	63	-304.0	-304.0	-304.0
chrX	118528767	118542724	118528725	118542759	JUNC00004874	3	+	42	35	-304.0	-304.0	-304.0
chrX	118538697	118542724	118538639	118542742	JUNC00004875	1	+	58	18	-304.0	-304.0	-304.0
chrX	118542841	118542925	118542768	118542999	JUNC00004876	34	+	73	74	-304.0	-304.0	-304.0
chrX	118543015	118543510	118542940	118543579	JUNC00004877	37	+	75	69	-304.0	-304.0	-304.0
chrX	118543593	118545322	118543525	118545392	JUNC00004878	60	+	68	70	-304.0	-304.0	-304.0
chrX	118545392	118546020	118545321	118546093	JUNC00004879	44	+	71	73	-304.0	-304.0	-304.0
chrX	118546116	118561382	118546046	118561455	JUNC00004880	28	+	70	73	-304.0	-304.0	-304.0
chrX	118561517	118566004	118561447	118566074	JUNC00004881	28	+	70	70	-304.0	-304.0	-304.0
chrX	118566182	118566573	118566107	118566645	JUNC00004882	44	+	75	72	-304.0	-304.0	-304.0
chrX	118566653	118568078	118566578	118568132	JUNC00004883	47	+	75	54	-304.0	-304.0	-304.0
chrX	118568162	118572322	118568087	118572393	JUNC00004884	26	+	75	71	-304.0	-304.0	-304.0
chrX	118572463	118573805	118572390	118573876	JUNC00004885	35	+	73	71	-304.0	-304.0	-304.0
chrX	118574018	118578524	118573943	118578598	JUNC00004886	48	+	75	74	-304.0	-304.0	-304.0
chrX	118578647	118580096	118578573	118580171	JUNC00004887	30	+	74	75	-304.0	-304.0	-304.0
chrX	118580179	118580872	118580132	118580901	JUNC00004889	1	+	47	29	-304.0	-304.0	-304.0
chrX	118580179	118584734	118580105	118584805	JUNC00004888	43	+	74	71	-304.0	-304.0	-304.0
chrX	118584857	118585040	118584784	118585110	JUNC00004890	35	+	73	70	-304.0	-304.0	-304.0
chrX	118585117	118588136	118585042	118588211	JUNC00004891	40	+	75	75	-304.0	-304.0	-304.0
chrX	118588321	118588412	118588251	118588477	JUNC00004892	38	+	70	65	-304.0	-304.0	-304.0
chrX	118588478	118590209	118588416	118590279	JUNC00004893	24	+	62	70	-304.0	-304.0	-304.0
chrX	118590302	118593213	118590229	118593285	JUNC00004894	25	+	73	72	-304.0	-304.0	-304.0
chrX	118593337	118597430	118593267	118597502	JUNC00004895	40	+	70	72	-304.0	-304.0	-304.0
chrX	118597552	118598029	118597480	118598102	JUNC00004896	47	+	72	73	-304.0	-304.0	-304.0
chrX	118598116	118599138	118598041	118599210	JUNC00004897	61	+	75	72	-304.0	-304.0	-304.0
chrX	118599228	118605237	118599157	118605309	JUNC00004898	29	+	71	72	-304.0	-304.0	-304.0
chrX	118605356	118608071	118605282	118608141	JUNC00004899	32	+	74	70	-304.0	-304.0	-304.0
chrX	118608141	118608230	118608071	118608290	JUNC00004900	25	+	70	60	-304.0	-304.0	-304.0
chrX	118608356	118609277	118608281	118609341	JUNC00004901	24	+	75	64	-304.0	-304.0	-304.0
chrX	118609349	118610271	118609277	118610346	JUNC00004902	33	+	72	75	-304.0	-304.0	-304.0
chrX	118610418	118614691	118610343	118614763	JUNC00004903	36	+	75	72	-304.0	-304.0	-304.0
chrX	118614775	118615599	118614705	118615674	JUNC00004904	23	+	70	75	-304.0	-304.0	-304.0
chrX	118616240	118618549	118616201	118618621	JUNC00004905	8	+	39	72	-304.0	-304.0	-304.0
chrX	118618728	118624538	118618653	118624613	JUNC00004906	42	+	75	75	-304.0	-304.0	-304.0
chrX	118618728	118627503	118618685	118627536	JUNC00004907	1	+	43	33	-304.0	-304.0	-304.0
chrX	118624655	118627503	118624580	118627578	JUNC00004908	52	+	75	75	-304.0	-304.0	-304.0
chrX	118627579	118628162	118627517	118628235	JUNC00004909	44	+	62	73	-304.0	-304.0	-304.0
chrX	118628272	118630378	118628197	118630453	JUNC00004910	57	+	75	75	-304.0	-304.0	-304.0
chrX	118630490	118636345	118630418	118636412	JUNC00004911	31	+	72	67	-304.0	-304.0	-304.0
chrX	118630490	118638079	118630435	118638100	JUNC00004912	1	+	55	21	-304.0	-304.0	-304.0
chrX	118636412	118638079	118636345	118638128	JUNC00004913	31	+	67	49	-304.0	-304.0	-304.0
chrX	118638127	118639434	118638079	118639507	JUNC00004914	37	+	48	73	-304.0	-304.0	-304.0
chrX	118639577	118641189	118639502	118641262	JUNC00004915	53	+	75	73	-304.0	-304.0	-304.0
chrX	118641305	118643456	118641230	118643531	JUNC00004916	44	+	75	75	-304.0	-304.0	-304.0
chrX	118643594	118648944	118643520	118649019	JUNC00004917	53	+	74	75	-304.0	-304.0	-304.0
chrX	118649127	118651963	118649052	118652034	JUNC00004918	64	+	75	71	-304.0	-304.0	-304.0
chrX	118652077	118654601	118652002	118654676	JUNC00004919	67	+	75	75	-304.0	-304.0	-304.0
chrX	118654817	118654903	118654745	118654961	JUNC00004920	43	+	72	58	-304.0	-304.0	-304.0
chrX	118654961	118662685	118654903	118662757	JUNC00004921	41	+	58	72	-304.0	-304.0	-304.0
chrX	118662792	118671022	118662717	118671096	JUNC00004922	47	+	75	74	-304.0	-304.0	-304.0
chrX	118671145	118675935	118671070	118676010	JUNC00004923	53	+	75	75	-304.0	-304.0	-304.0
chrX	118676049	118676590	118675975	118676665	JUNC00004924	48	+	74	75	-304.0	-304.0	-304.0
chrX	118676737	118680481	118676664	118680556	JUNC00004925	53	+	73	75	-304.0	-304.0	-304.0
chrX	118678210	118680481	118678164	118680511	JUNC00004926	1	+	46	30	-304.0	-304.0	-304.0
chrX	118680692	118681057	118680619	118681132	JUNC00004927	59	+	73	75	-304.0	-304.0	-304.0
chrX	118681248	118681693	118681179	118681768	JUNC00004928	55	+	69	75	-304.0	-304.0	-304.0
chrX	118681794	118683078	118681719	118683153	JUNC00004929	62	+	75	75	-304.0	-304.0	-304.0
chrX	118727726	118741016	118727707	118741073	JUNC00004930	1	+	19	57	-304.0	-304.0	-304.0
chrX	118741156	118746953	118741104	118747028	JUNC00004931	5	+	52	75	-304.0	-304.0	-304.0
chrX	118747092	118749657	118747045	118749719	JUNC00004932	5	+	47	62	-304.0	-304.0	-304.0
chrX	118749778	118758054	118749704	118758109	JUNC00004933	3	+	74	55	-304.0	-304.0	-304.0
chrX	118758242	118761137	118758177	118761208	JUNC00004934	5	+	65	71	-304.0	-304.0	-304.0
chrX	118761289	118766529	118761225	118766577	JUNC00004935	4	+	64	48	-304.0	-304.0	-304.0
chrX	118766577	118766843	118766529	118766862	JUNC00004936	1	+	48	19	-304.0	-304.0	-304.0
chrX	118766976	118773878	118766948	118773939	JUNC00004937	3	+	28	61	-304.0	-304.0	-304.0
chrX	118773975	118776426	118773901	118776461	JUNC00004938	2	+	74	35	-304.0	-304.0	-304.0
chrX	118776511	118791761	118776443	118791801	JUNC00004939	4	+	68	40	-304.0	-304.0	-304.0
chrX	118843434	118852955	118843400	118852997	JUNC00004940	1	-	34	42	-304.0	-304.0	-304.0
chrX	118975597	118978344	118975587	118978410	JUNC00004941	1	+	10	66	-304.0	-304.0	-304.0
chrX	118985980	118986924	118985924	118986941	JUNC00004942	1	+	56	17	-304.0	-304.0	-304.0
chrX	118989672	118990469	118989603	118990513	JUNC00004943	2	+	69	44	-304.0	-304.0	-304.0
chrX	119006235	119009125	119006176	119009164	JUNC00004944	4	+	59	39	-304.0	-304.0	-304.0
chrX	119009247	119011814	119009177	119011820	JUNC00004945	1	+	70	6	-304.0	-304.0	-304.0
chrX	119013201	119014206	119013142	119014253	JUNC00004946	2	+	59	47	-304.0	-304.0	-304.0
chrX	119014356	119017534	119014320	119017574	JUNC00004947	1	+	36	40	-304.0	-304.0	-304.0
chrX	119178789	119187983	119178751	119188021	JUNC00004948	1	-	38	38	-304.0	-304.0	-304.0
chrX	119236691	119238236	119236646	119238267	JUNC00004950	1	+	45	31	-304.0	-304.0	-304.0
chrX	119236691	119240308	119236620	119240382	JUNC00004949	91	+	71	74	-304.0	-304.0	-304.0
chrX	119240464	119243150	119240391	119243224	JUNC00004951	124	+	73	74	-304.0	-304.0	-304.0
chrX	119399678	119406459	119399634	119406534	JUNC00004952	13	+	44	75	-304.0	-304.0	-304.0
chrX	119406701	119410189	119406629	119410255	JUNC00004953	27	+	72	66	-304.0	-304.0	-304.0
chrX	119410362	119419258	119410323	119419295	JUNC00004955	1	+	39	37	-304.0	-304.0	-304.0
chrX	119410362	119426181	119410325	119426220	JUNC00004956	1	+	37	39	-304.0	-304.0	-304.0
chrX	119410362	119452008	119410288	119452081	JUNC00004954	36	+	74	73	-304.0	-304.0	-304.0
chrX	119417640	119426181	119417619	119426236	JUNC00004957	1	+	21	55	-304.0	-304.0	-304.0
chrX	119452143	119452864	119452093	119452936	JUNC00004958	20	+	50	72	-304.0	-304.0	-304.0
chrX	119461221	119515458	119461188	119515501	JUNC00004959	1	+	33	43	-304.0	-304.0	-304.0
chrX	119467750	119468981	119467679	119469016	JUNC00004960	2	-	71	35	-304.0	-304.0	-304.0
chrX	119468626	119469660	119468551	119469735	JUNC00004961	1314	+	75	75	-304.0	-304.0	-304.0
chrX	119468626	119469666	119468572	119469741	JUNC00004965	33	+	54	75	-304.0	-304.0	-304.0
chrX	119468626	119469976	119468568	119470051	JUNC00004964	52	+	58	75	-304.0	-304.0	-304.0
chrX	119468626	119470095	119468551	119470147	JUNC00004963	109	+	75	52	-304.0	-304.0	-304.0
chrX	119468626	119470372	119468551	119470447	JUNC00004962	52	+	75	75	-304.0	-304.0	-304.0
chrX	119469766	119469973	119469695	119470048	JUNC00004967	10	+	71	75	-304.0	-304.0	-304.0
chrX	119469974	119469995	119469900	119470027	JUNC00004968	11	?	74	32	110.0	110.0	110.0
chrX	119470147	119470372	119470072	119470447	JUNC00004966	2592	+	75	75	-304.0	-304.0	-304.0
chrX	119470513	119470900	119470438	119470975	JUNC00004969	2808	+	75	75	-304.0	-304.0	-304.0
chrX	119471003	119471077	119470978	119471128	JUNC00004970	1	?	25	51	-304.0	-304.0	-304.0
chrX	119486713	119522826	119486654	119522843	JUNC00004971	1	+	59	17	-304.0	-304.0	-304.0
chrX	119517579	119521914	119517563	119521974	JUNC00004972	1	-	16	60	-304.0	-304.0	-304.0
chrX	119536965	119541327	119536940	119541378	JUNC00004973	1	-	25	51	-304.0	-304.0	-304.0
chrX	119539789	119541327	119539714	119541402	JUNC00004974	104	-	75	75	-304.0	-304.0	-304.0
chrX	119541420	119542504	119541345	119542579	JUNC00004975	117	-	75	75	-304.0	-304.0	-304.0
chrX	119542594	119544352	119542519	119544426	JUNC00004976	92	-	75	74	-304.0	-304.0	-304.0
chrX	119544491	119545462	119544420	119545506	JUNC00004977	64	-	71	44	-304.0	-304.0	-304.0
chrX	119545504	119560267	119545460	119560342	JUNC00004978	64	-	44	75	-304.0	-304.0	-304.0
chrX	119560385	119565231	119560310	119565305	JUNC00004979	105	-	75	74	-304.0	-304.0	-304.0
chrX	119574755	119574900	119574680	119574974	JUNC00004980	93	+	75	74	-304.0	-304.0	-304.0
chrX	119574981	119575374	119574906	119575429	JUNC00004981	151	+	75	55	-304.0	-304.0	-304.0
chrX	119575400	119581506	119575373	119581581	JUNC00004982	158	+	27	75	-304.0	-304.0	-304.0
chrX	119575400	119582587	119575374	119582662	JUNC00004983	5	+	26	75	-304.0	-304.0	-304.0
chrX	119576636	119581506	119576599	119581581	JUNC00004984	15	+	37	75	-304.0	-304.0	-304.0
chrX	119582676	119583126	119582601	119583201	JUNC00004985	257	+	75	75	-304.0	-304.0	-304.0
chrX	119591309	119592382	119591238	119592457	JUNC00004986	47	-	71	75	-304.0	-304.0	-304.0
chrX	119592513	119593098	119592455	119593135	JUNC00004989	2	-	58	37	-304.0	-304.0	-304.0
chrX	119592513	119603461	119592439	119603502	JUNC00004988	2	-	74	41	-304.0	-304.0	-304.0
chrX	119592513	119605730	119592439	119605796	JUNC00004987	29	-	74	66	-304.0	-304.0	-304.0
chrX	119594863	119657141	119594844	119657197	JUNC00004990	1	-	19	56	120.0	-304.0	120.0
chrX	119596891	119630023	119596862	119630065	JUNC00004991	1	+	29	42	-304.0	-304.0	-304.0
chrX	119600862	119620852	119600841	119620907	JUNC00004992	1	-	21	55	-304.0	-304.0	-304.0
chrX	119616742	119625334	119616667	119625379	JUNC00004993	6	-	75	45	-304.0	-304.0	-304.0
chrX	119616742	119629317	119616720	119629371	JUNC00004995	1	-	22	54	-304.0	-304.0	-304.0
chrX	119617099	119617119	119617072	119617168	JUNC00004996	1	?	27	49	112.0	70.0	112.0
chrX	119618786	119625334	119618712	119625379	JUNC00004997	30	-	74	45	-304.0	-304.0	-304.0
chrX	119618786	119629317	119618738	119629392	JUNC00004998	5	-	48	75	-304.0	-304.0	-304.0
chrX	119620051	119625334	119619976	119625396	JUNC00004999	628	-	75	62	-304.0	-304.0	-304.0
chrX	119620051	119629317	119620023	119629392	JUNC00005000	5	-	28	75	-304.0	-304.0	-304.0
chrX	119620070	119625334	119620029	119625368	JUNC00005001	1	-	41	34	-304.0	-304.0	-304.0
chrX	119625379	119629317	119625309	119629392	JUNC00004994	608	-	70	75	-304.0	-304.0	-304.0
chrX	119625396	119629317	119625334	119629390	JUNC00005002	14	-	62	73	-304.0	-304.0	-304.0
chrX	119628210	119639891	119628173	119639929	JUNC00005003	1	-	37	38	110.0	108.0	110.0
chrX	119629508	119633359	119629433	119633434	JUNC00005004	948	-	75	75	-304.0	-304.0	-304.0
chrX	119629508	119640691	119629433	119640716	JUNC00005005	2	-	75	25	-304.0	-304.0	-304.0
chrX	119633485	119637026	119633465	119637082	JUNC00005008	1	-	20	56	-304.0	-304.0	-304.0
chrX	119633492	119637026	119633417	119637101	JUNC00005006	996	-	75	75	-304.0	-304.0	-304.0
chrX	119633492	119640691	119633417	119640766	JUNC00005007	22	-	75	75	-304.0	-304.0	-304.0
chrX	119637195	119640691	119637120	119640766	JUNC00005009	1039	-	75	75	-304.0	-304.0	-304.0
chrX	119640788	119649936	119640713	119650011	JUNC00005010	1107	-	75	75	-304.0	-304.0	-304.0
chrX	119640788	119675553	119640718	119675628	JUNC00005011	16	-	70	75	-304.0	-304.0	-304.0
chrX	119640818	119649936	119640765	119649959	JUNC00005012	2	-	53	23	-304.0	-304.0	-304.0
chrX	119650098	119652853	119650023	119652928	JUNC00005013	936	-	75	75	-304.0	-304.0	-304.0
chrX	119651606	119723957	119651562	119723989	JUNC00005014	1	+	44	32	-304.0	-304.0	-304.0
chrX	119653040	119663481	119652966	119663556	JUNC00005015	882	-	74	75	-304.0	-304.0	-304.0
chrX	119663674	119675553	119663626	119675581	JUNC00005018	1	-	48	28	-304.0	-304.0	-304.0
chrX	119663677	119675553	119663602	119675628	JUNC00005016	760	-	75	75	-304.0	-304.0	-304.0
chrX	119663677	119693075	119663602	119693095	JUNC00005017	11	-	75	20	-304.0	-304.0	-304.0
chrX	119675668	119693075	119675593	119693144	JUNC00005019	405	-	75	69	-304.0	-304.0	-304.0
chrX	119675668	119693078	119675593	119693152	JUNC00005020	8	-	75	74	-304.0	-304.0	-304.0
chrX	119730726	119774136	119730694	119774190	JUNC00005021	4	-	32	54	-304.0	-304.0	-304.0
chrX	119769258	119800968	119769234	119801020	JUNC00005022	1	-	24	52	-304.0	-304.0	-304.0
chrX	119769342	119789907	119769327	119789968	JUNC00005023	1	-	15	61	-304.0	-304.0	-304.0
chrX	119783060	119784850	119783050	119784908	JUNC00005024	1	-	10	58	-304.0	-304.0	-304.0
chrX	119786717	119789907	119786642	119789982	JUNC00005025	125	-	75	75	-304.0	-304.0	-304.0
chrX	119786732	119787280	119786657	119787315	JUNC00005027	35	-	75	35	-304.0	-304.0	-304.0
chrX	119786732	119789907	119786657	119789982	JUNC00005026	495	-	75	75	-304.0	-304.0	-304.0
chrX	119789999	119791573	119789924	119791606	JUNC00005028	9	-	75	33	-304.0	-304.0	-304.0
chrX	119790011	119791573	119789936	119791647	JUNC00005029	313	-	75	74	-304.0	-304.0	-304.0
chrX	119818123	119860925	119818084	119860962	JUNC00005030	1	+	39	37	-304.0	-304.0	-304.0
chrX	119835027	119837756	119834953	119837830	JUNC00005031	69	-	74	74	-304.0	-304.0	-304.0
chrX	119838051	119838366	119837978	119838440	JUNC00005032	77	-	73	74	-304.0	-304.0	-304.0
chrX	119838527	119840645	119838468	119840662	JUNC00005034	1	-	59	17	-304.0	-304.0	-304.0
chrX	119838527	119841075	119838453	119841150	JUNC00005033	49	-	74	75	-304.0	-304.0	-304.0
chrX	119840684	119841075	119840657	119841124	JUNC00005035	2	-	27	49	-304.0	-304.0	-304.0
chrX	119841258	119841734	119841183	119841781	JUNC00005036	46	-	75	47	-304.0	-304.0	-304.0
chrX	119841778	119843190	119841734	119843265	JUNC00005037	47	-	44	75	-304.0	-304.0	-304.0
chrX	119843301	119845197	119843230	119845271	JUNC00005038	67	-	71	74	-304.0	-304.0	-304.0
chrX	119845296	119851494	119845224	119851568	JUNC00005039	35	-	72	74	-304.0	-304.0	-304.0
chrX	119851601	119851766	119851526	119851834	JUNC00005040	39	-	75	68	-304.0	-304.0	-304.0
chrX	119851873	119852772	119851801	119852847	JUNC00005041	49	-	72	75	-304.0	-304.0	-304.0
chrX	119872013	119873303	119871938	119873378	JUNC00005042	1588	+	75	75	-304.0	-304.0	-304.0
chrX	119873393	119875345	119873364	119875392	JUNC00005044	1	+	29	47	-304.0	-304.0	-304.0
chrX	119873393	119876513	119873318	119876588	JUNC00005043	953	+	75	75	-304.0	-304.0	-304.0
chrX	119902786	119924781	119902757	119924828	JUNC00005045	1	+	29	47	-304.0	-304.0	-304.0
chrX	119902939	119907379	119902911	119907427	JUNC00005046	1	-	28	48	-304.0	-304.0	-304.0
chrX	119925394	119930015	119925319	119930090	JUNC00005047	63	-	75	75	-304.0	-304.0	-304.0
chrX	119926515	120006934	119926464	120006959	JUNC00005048	1	-	51	25	-304.0	-304.0	-304.0
chrX	119930165	119931935	119930090	119932010	JUNC00005049	68	-	75	75	-304.0	-304.0	-304.0
chrX	119932011	119932106	119931937	119932181	JUNC00005050	76	-	74	75	-304.0	-304.0	-304.0
chrX	119932216	119934493	119932141	119934558	JUNC00005051	69	-	75	65	-304.0	-304.0	-304.0
chrX	119934557	119936296	119934492	119936367	JUNC00005052	69	-	65	71	-304.0	-304.0	-304.0
chrX	119936431	119936611	119936367	119936682	JUNC00005053	49	-	64	71	-304.0	-304.0	-304.0
chrX	119936682	119938729	119936611	119938800	JUNC00005054	65	-	71	71	-304.0	-304.0	-304.0
chrX	119936682	119943219	119936659	119943272	JUNC00005055	1	-	23	53	-304.0	-304.0	-304.0
chrX	119938810	119943219	119938736	119943294	JUNC00005056	46	-	74	75	-304.0	-304.0	-304.0
chrX	119991701	119992500	119991634	119992572	JUNC00005057	3	+	67	72	-304.0	-304.0	-304.0
chrX	120112914	120115464	120112868	120115494	JUNC00005058	1	-	46	30	-304.0	-304.0	-304.0
chrX	120119698	120130839	120119663	120130880	JUNC00005059	1	-	35	41	-304.0	-304.0	-304.0
chrX	120119698	120136105	120119673	120136156	JUNC00005060	1	-	25	51	-304.0	-304.0	-304.0
chrX	120136207	120137041	120136153	120137063	JUNC00005061	1	-	54	22	-304.0	-304.0	-304.0
chrX	120178556	120244763	120178519	120244802	JUNC00005062	1	-	37	39	-304.0	-304.0	-304.0
chrX	120238242	120240226	120238186	120240296	JUNC00005063	8	-	56	70	-304.0	-304.0	-304.0
chrX	120240355	120244763	120240280	120244836	JUNC00005064	8	-	75	73	-304.0	-304.0	-304.0
chrX	120241021	120244763	120240976	120244794	JUNC00005065	1	-	45	31	-304.0	-304.0	-304.0
chrX	120250977	120252668	120250924	120252693	JUNC00005067	2	+	53	25	-304.0	-304.0	-304.0
chrX	120250977	120253413	120250902	120253486	JUNC00005066	27	+	75	73	-304.0	-304.0	-304.0
chrX	120252770	120253413	120252709	120253488	JUNC00005068	7	+	61	75	-304.0	-304.0	-304.0
chrX	120261028	120268243	120260969	120268318	JUNC00005069	5	-	59	75	-304.0	-304.0	-304.0
chrX	120268387	120276884	120268328	120276901	JUNC00005070	1	-	59	17	-304.0	-304.0	-304.0
chrX	120285215	120287153	120285174	120287188	JUNC00005071	1	-	41	35	-304.0	-304.0	-304.0
chrX	120287222	120291250	120287151	120291299	JUNC00005072	6	-	71	49	-304.0	-304.0	-304.0
chrX	120291340	120293988	120291272	120294051	JUNC00005073	9	-	68	63	-304.0	-304.0	-304.0
chrX	120294051	120304329	120293995	120304395	JUNC00005075	3	-	56	66	-304.0	-304.0	-304.0
chrX	120294051	120304348	120293988	120304401	JUNC00005074	6	-	63	53	-304.0	-304.0	-304.0
chrX	120431462	120441729	120431391	120441804	JUNC00005076	76	-	71	75	-304.0	-304.0	-304.0
chrX	120439293	120441729	120439222	120441804	JUNC00005077	109	-	71	75	-304.0	-304.0	-304.0
chrX	120441894	120442598	120441819	120442663	JUNC00005078	197	-	75	65	-304.0	-304.0	-304.0
chrX	120442662	120446304	120442598	120446379	JUNC00005079	192	-	64	75	-304.0	-304.0	-304.0
chrX	120446427	120447840	120446352	120447915	JUNC00005080	122	-	75	75	-304.0	-304.0	-304.0
chrX	120448025	120448969	120447950	120449043	JUNC00005081	145	-	75	74	-304.0	-304.0	-304.0
chrX	120449128	120455356	120449053	120455431	JUNC00005082	155	-	75	75	-304.0	-304.0	-304.0
chrX	120449550	120498669	120449530	120498722	JUNC00005083	1	+	20	53	-304.0	-304.0	-304.0
chrX	120453578	120460049	120453538	120460085	JUNC00005084	1	+	40	36	-304.0	-304.0	-304.0
chrX	120455570	120456650	120455496	120456725	JUNC00005085	130	-	74	75	-304.0	-304.0	-304.0
chrX	120456769	120469105	120456694	120469179	JUNC00005086	96	-	75	74	-304.0	-304.0	-304.0
chrX	120526856	120530101	120526781	120530175	JUNC00005087	106	-	75	74	-304.0	-304.0	-304.0
chrX	120530254	120532421	120530183	120532496	JUNC00005088	114	-	71	75	-304.0	-304.0	-304.0
chrX	120532594	120534480	120532520	120534554	JUNC00005089	146	-	74	74	-304.0	-304.0	-304.0
chrX	120534586	120535829	120534512	120535904	JUNC00005090	117	-	74	75	-304.0	-304.0	-304.0
chrX	120535943	120536926	120535871	120537000	JUNC00005091	85	-	72	74	-304.0	-304.0	-304.0
chrX	120537034	120538117	120536984	120538170	JUNC00005093	3	-	50	53	-304.0	-304.0	-304.0
chrX	120537034	120538123	120536960	120538197	JUNC00005092	107	-	74	74	-304.0	-304.0	-304.0
chrX	120538209	120538659	120538135	120538734	JUNC00005094	103	-	74	75	-304.0	-304.0	-304.0
chrX	120538770	120539267	120538699	120539342	JUNC00005095	90	-	71	75	-304.0	-304.0	-304.0
chrX	120539372	120540369	120539297	120540444	JUNC00005096	111	-	75	75	-304.0	-304.0	-304.0
chrX	120540562	120541601	120540487	120541676	JUNC00005097	106	-	75	75	-304.0	-304.0	-304.0
chrX	120541720	120542965	120541645	120543033	JUNC00005098	88	-	75	68	-304.0	-304.0	-304.0
chrX	120543033	120543726	120542963	120543801	JUNC00005099	105	-	70	75	-304.0	-304.0	-304.0
chrX	120543809	120544113	120543736	120544188	JUNC00005100	90	-	73	75	-304.0	-304.0	-304.0
chrX	120544203	120544480	120544128	120544552	JUNC00005101	84	-	75	72	-304.0	-304.0	-304.0
chrX	120544643	120545443	120544572	120545518	JUNC00005102	84	-	71	75	-304.0	-304.0	-304.0
chrX	120545517	120546546	120545442	120546616	JUNC00005103	68	-	75	70	-304.0	-304.0	-304.0
chrX	120547239	120554907	120547164	120554956	JUNC00005105	3	-	75	49	-304.0	-304.0	-304.0
chrX	120547239	120557923	120547164	120557998	JUNC00005104	66	-	75	75	-304.0	-304.0	-304.0
chrX	120554949	120557923	120554922	120557972	JUNC00005106	1	-	27	49	-304.0	-304.0	-304.0
chrX	120558039	120559778	120557973	120559819	JUNC00005108	7	-	66	41	-304.0	-304.0	-304.0
chrX	120558039	120560082	120557968	120560157	JUNC00005107	95	-	71	75	-304.0	-304.0	-304.0
chrX	120560625	120561371	120560552	120561446	JUNC00005109	26	-	73	75	-304.0	-304.0	-304.0
chrX	120562064	120590441	120562005	120590458	JUNC00005110	1	+	59	17	-304.0	-304.0	-304.0
chrX	120585146	120971581	120585129	120971638	JUNC00005111	1	-	17	57	-304.0	-304.0	-304.0
chrX	120585146	120976441	120585129	120976498	JUNC00005112	1	-	17	57	-304.0	-304.0	-304.0
chrX	120591397	120594083	120591351	120594109	JUNC00005113	1	+	46	26	-304.0	-304.0	-304.0
chrX	120604247	120605406	120604172	120605481	JUNC00005114	284	+	75	75	-304.0	-304.0	-304.0
chrX	120604867	120605406	120604802	120605476	JUNC00005115	9	+	65	70	-304.0	-304.0	-304.0
chrX	120605559	120606078	120605484	120606153	JUNC00005116	236	+	75	75	-304.0	-304.0	-304.0
chrX	120606176	120608224	120606101	120608298	JUNC00005117	233	+	75	74	-304.0	-304.0	-304.0
chrX	120606176	120612182	120606144	120612257	JUNC00005118	4	+	32	75	-304.0	-304.0	-304.0
chrX	120608358	120611010	120608283	120611078	JUNC00005119	275	+	75	68	-304.0	-304.0	-304.0
chrX	120611078	120612182	120611010	120612257	JUNC00005120	344	+	68	75	-304.0	-304.0	-304.0
chrX	120612471	120614001	120612427	120614032	JUNC00005121	1	+	44	31	-304.0	-304.0	-304.0
chrX	120627171	120629916	120627096	120629991	JUNC00005122	59	-	75	75	-304.0	-304.0	-304.0
chrX	120629224	120629916	120629175	120629943	JUNC00005123	1	-	49	27	-304.0	-304.0	-304.0
chrX	120687110	120704452	120687093	120704508	JUNC00005124	1	+	17	56	-304.0	-304.0	-304.0
chrX	121151724	121154754	121151683	121154789	JUNC00005125	1	+	41	35	-304.0	-304.0	-304.0
chrX	121560542	121736190	121560489	121736213	JUNC00005126	1	+	53	23	-304.0	-304.0	-304.0
chrX	121736294	121864124	121736239	121864145	JUNC00005127	1	+	55	21	-304.0	-304.0	-304.0
chrX	121864285	121867784	121864243	121867818	JUNC00005128	1	+	42	34	-304.0	-304.0	-304.0
chrX	123185990	123202635	123185969	123202690	JUNC00005129	1	+	21	55	-304.0	-304.0	-304.0
chrX	123253542	123326025	123253490	123326076	JUNC00005130	3	+	52	51	-304.0	-304.0	-304.0
chrX	123358619	123358704	123358576	123358773	JUNC00005131	4	+	43	69	-304.0	-304.0	-304.0
chrX	123358800	123361242	123358752	123361285	JUNC00005132	4	+	48	43	-304.0	-304.0	-304.0
chrX	123358800	123394967	123358779	123395022	JUNC00005133	1	+	21	55	-304.0	-304.0	-304.0
chrX	123395129	123398635	123395079	123398708	JUNC00005134	6	+	50	73	-304.0	-304.0	-304.0
chrX	123403098	123403411	123403078	123403481	JUNC00005135	2	+	20	70	-304.0	-304.0	-304.0
chrX	123403519	123404707	123403478	123404742	JUNC00005136	1	+	41	35	-304.0	-304.0	-304.0
chrX	123404914	123417401	123404875	123417451	JUNC00005137	2	+	39	50	-304.0	-304.0	-304.0
chrX	123480177	123482798	123480147	123482844	JUNC00005138	1	+	30	46	-304.0	-304.0	-304.0
chrX	123560537	123590584	123560493	123590616	JUNC00005139	1	-	44	32	-304.0	-304.0	-304.0
chrX	123601338	123610917	123601267	123610967	JUNC00005140	59	-	71	50	-304.0	-304.0	-304.0
chrX	123603748	123610917	123603676	123610963	JUNC00005141	27	-	72	46	-304.0	-304.0	-304.0
chrX	123611516	123613398	123611441	123613472	JUNC00005142	142	-	75	74	-304.0	-304.0	-304.0
chrX	123611516	123613638	123611486	123613684	JUNC00005144	1	-	30	46	-304.0	-304.0	-304.0
chrX	123611516	123614051	123611441	123614126	JUNC00005143	10	-	75	75	-304.0	-304.0	-304.0
chrX	123613556	123613638	123613487	123613709	JUNC00005145	106	-	69	71	-304.0	-304.0	-304.0
chrX	123613708	123614051	123613638	123614126	JUNC00005146	155	-	70	75	-304.0	-304.0	-304.0
chrX	123614189	123619400	123614114	123619475	JUNC00005147	165	-	75	75	-304.0	-304.0	-304.0
chrX	123619436	123620092	123619400	123620132	JUNC00005149	1	-	36	40	-304.0	-304.0	-304.0
chrX	123619436	123620906	123619400	123620966	JUNC00005148	130	-	36	60	-304.0	-304.0	-304.0
chrX	123619517	123620906	123619455	123620965	JUNC00005151	16	-	62	59	-304.0	-304.0	-304.0
chrX	123620965	123621156	123620898	123621231	JUNC00005150	131	-	67	75	-304.0	-304.0	-304.0
chrX	123621587	123622757	123621512	123622829	JUNC00005152	48	-	75	72	-304.0	-304.0	-304.0
chrX	123622860	123623104	123622786	123623177	JUNC00005153	62	-	74	73	-304.0	-304.0	-304.0
chrX	123623283	123623643	123623208	123623709	JUNC00005155	14	-	75	66	-304.0	-304.0	-304.0
chrX	123623283	123623786	123623208	123623860	JUNC00005154	52	-	75	74	-304.0	-304.0	-304.0
chrX	123623709	123623786	123623643	123623854	JUNC00005156	15	-	66	68	-304.0	-304.0	-304.0
chrX	123623971	123624059	123623899	123624134	JUNC00005157	87	-	72	75	-304.0	-304.0	-304.0
chrX	123624191	123624540	123624116	123624615	JUNC00005158	117	-	75	75	-304.0	-304.0	-304.0
chrX	123624669	123625911	123624595	123625986	JUNC00005159	90	-	74	75	-304.0	-304.0	-304.0
chrX	123626069	123626520	123625996	123626594	JUNC00005160	86	-	73	74	-304.0	-304.0	-304.0
chrX	123626662	123627692	123626588	123627767	JUNC00005161	76	-	74	75	-304.0	-304.0	-304.0
chrX	123627968	123631687	123627893	123631762	JUNC00005162	79	-	75	75	-304.0	-304.0	-304.0
chrX	123633040	123633952	123632969	123634027	JUNC00005163	72	-	71	75	-304.0	-304.0	-304.0
chrX	123634070	123636078	123633995	123636152	JUNC00005164	70	-	75	74	-304.0	-304.0	-304.0
chrX	123636175	123637201	123636100	123637226	JUNC00005165	6	-	75	25	-304.0	-304.0	-304.0
chrX	123636175	123638042	123636100	123638116	JUNC00005166	80	-	75	74	-304.0	-304.0	-304.0
chrX	123637682	123655940	123637656	123655990	JUNC00005167	1	-	26	50	-304.0	-304.0	-304.0
chrX	123638123	123638933	123638048	123639004	JUNC00005168	77	-	75	71	-304.0	-304.0	-304.0
chrX	123639027	123640525	123638978	123640596	JUNC00005170	5	-	49	71	-304.0	-304.0	-304.0
chrX	123639027	123640537	123638954	123640610	JUNC00005169	47	-	73	73	-304.0	-304.0	-304.0
chrX	123640622	123644574	123640547	123644649	JUNC00005171	83	-	75	75	-304.0	-304.0	-304.0
chrX	123644676	123644778	123644601	123644849	JUNC00005172	66	-	75	71	-304.0	-304.0	-304.0
chrX	123644909	123645333	123644835	123645377	JUNC00005173	100	-	74	44	-304.0	-304.0	-304.0
chrX	123645375	123665641	123645332	123665714	JUNC00005174	98	-	43	73	-304.0	-304.0	-304.0
chrX	123665837	123667105	123665762	123667180	JUNC00005175	56	-	75	75	-304.0	-304.0	-304.0
chrX	123667278	123668158	123667205	123668233	JUNC00005176	99	-	73	75	-304.0	-304.0	-304.0
chrX	123668314	123671668	123668239	123671743	JUNC00005177	84	-	75	75	-304.0	-304.0	-304.0
chrX	123671761	123678083	123671718	123678146	JUNC00005180	2	-	43	63	-304.0	-304.0	-304.0
chrX	123671761	123686547	123671688	123686622	JUNC00005178	71	-	73	75	-304.0	-304.0	-304.0
chrX	123671761	123696020	123671718	123696094	JUNC00005179	2	-	43	74	-304.0	-304.0	-304.0
chrX	123678221	123686547	123678203	123686605	JUNC00005181	1	-	18	58	-304.0	-304.0	-304.0
chrX	123686714	123696020	123686639	123696094	JUNC00005182	58	-	75	74	-304.0	-304.0	-304.0
chrX	123696154	123696720	123696080	123696795	JUNC00005183	78	-	74	75	-304.0	-304.0	-304.0
chrX	123696842	123697680	123696767	123697754	JUNC00005184	78	-	75	74	-304.0	-304.0	-304.0
chrX	123697751	123703453	123697680	123703505	JUNC00005185	59	-	71	52	-304.0	-304.0	-304.0
chrX	123703505	123706857	123703453	123706931	JUNC00005186	56	-	52	74	-304.0	-304.0	-304.0
chrX	123706949	123712849	123706874	123712908	JUNC00005187	59	-	75	59	-304.0	-304.0	-304.0
chrX	123709488	123802984	123709457	123803029	JUNC00005189	1	+	31	45	-304.0	-304.0	-304.0
chrX	123712908	123732951	123712849	123733020	JUNC00005188	46	-	59	69	-304.0	-304.0	-304.0
chrX	123739696	123838333	123739672	123838385	JUNC00005190	1	-	24	52	-304.0	-304.0	-304.0
chrX	123763824	123833940	123763797	123833989	JUNC00005191	1	+	27	49	-304.0	-304.0	-304.0
chrX	123800697	123870216	123800677	123870264	JUNC00005192	1	-	20	48	-304.0	-304.0	-304.0
chrX	123848527	123910797	123848480	123910867	JUNC00005193	4	+	47	70	120.0	124.0	124.0
chrX	123859905	123885630	123859870	123885677	JUNC00005194	2	+	35	47	-304.0	-304.0	-304.0
chrX	123860293	123885630	123860236	123885704	JUNC00005195	7	+	57	74	-304.0	-304.0	-304.0
chrX	123860293	123888618	123860270	123888685	JUNC00005196	6	+	23	67	-304.0	-304.0	-304.0
chrX	123875251	123877297	123875227	123877349	JUNC00005197	1	-	24	52	-304.0	-304.0	-304.0
chrX	123886539	123888618	123886469	123888692	JUNC00005198	29	+	70	74	-304.0	-304.0	-304.0
chrX	123888718	123891237	123888648	123891312	JUNC00005199	39	+	70	75	-304.0	-304.0	-304.0
chrX	123890248	123919912	123890230	123919970	JUNC00005200	1	-	18	58	136.0	128.0	136.0
chrX	123891316	123892730	123891245	123892773	JUNC00005201	35	+	71	43	-304.0	-304.0	-304.0
chrX	123892773	123900492	123892730	123900567	JUNC00005202	37	+	43	75	-304.0	-304.0	-304.0
chrX	123900693	123906987	123900619	123907057	JUNC00005203	43	+	74	70	-304.0	-304.0	-304.0
chrX	123909151	123911367	123909093	123911385	JUNC00005204	1	-	58	18	-304.0	-304.0	-304.0
chrX	123913016	123913244	123912944	123913319	JUNC00005205	5	+	72	75	-304.0	-304.0	-304.0
chrX	123959405	123961188	123959352	123961211	JUNC00005206	1	-	53	23	-304.0	-304.0	-304.0
chrX	123960866	124021366	123960792	124021432	JUNC00005208	11	+	74	66	-304.0	-304.0	-304.0
chrX	123960866	124022530	123960792	124022605	JUNC00005207	35	+	74	75	-304.0	-304.0	-304.0
chrX	123961856	124021366	123961781	124021427	JUNC00005210	7	+	75	61	-304.0	-304.0	-304.0
chrX	123961856	124022530	123961781	124022605	JUNC00005211	12	+	75	75	-304.0	-304.0	-304.0
chrX	123962106	124021366	123962080	124021426	JUNC00005212	2	+	26	60	-304.0	-304.0	-304.0
chrX	123963327	124021366	123963270	124021385	JUNC00005213	1	+	57	19	-304.0	-304.0	-304.0
chrX	123968143	123974471	123968126	123974527	JUNC00005214	1	-	17	56	-304.0	-304.0	-304.0
chrX	124001322	124006671	124001290	124006715	JUNC00005215	1	-	32	44	-304.0	-304.0	-304.0
chrX	124021431	124022530	124021366	124022605	JUNC00005209	26	+	65	75	-304.0	-304.0	-304.0
chrX	124022671	124025839	124022597	124025913	JUNC00005216	120	+	74	74	-304.0	-304.0	-304.0
chrX	124025918	124026564	124025890	124026625	JUNC00005218	2	+	28	61	-304.0	-304.0	-304.0
chrX	124025918	124030960	124025843	124031033	JUNC00005217	145	+	75	73	-304.0	-304.0	-304.0
chrX	124026687	124030960	124026666	124031015	JUNC00005219	1	+	21	55	-304.0	-304.0	-304.0
chrX	124031125	124037526	124031051	124037601	JUNC00005220	119	+	74	75	-304.0	-304.0	-304.0
chrX	124031873	124079281	124031853	124079334	JUNC00005221	1	+	20	53	-304.0	-304.0	-304.0
chrX	124037623	124042568	124037548	124042643	JUNC00005222	146	+	75	75	-304.0	-304.0	-304.0
chrX	124039767	124042568	124039719	124042642	JUNC00005223	4	+	48	74	-304.0	-304.0	-304.0
chrX	124042645	124045163	124042570	124045238	JUNC00005224	130	+	75	75	-304.0	-304.0	-304.0
chrX	124045368	124047353	124045294	124047428	JUNC00005225	83	+	74	75	-304.0	-304.0	-304.0
chrX	124047505	124049004	124047430	124049078	JUNC00005226	126	+	75	74	-304.0	-304.0	-304.0
chrX	124049078	124050185	124049003	124050259	JUNC00005227	124	+	75	74	-304.0	-304.0	-304.0
chrX	124050309	124051120	124050235	124051195	JUNC00005228	110	+	74	75	-304.0	-304.0	-304.0
chrX	124051219	124051314	124051144	124051388	JUNC00005229	80	+	75	74	-304.0	-304.0	-304.0
chrX	124051394	124056127	124051319	124056201	JUNC00005230	119	+	75	74	-304.0	-304.0	-304.0
chrX	124051394	124057865	124051353	124057936	JUNC00005231	3	+	41	71	-304.0	-304.0	-304.0
chrX	124056235	124056915	124056194	124056950	JUNC00005233	1	+	41	35	-304.0	-304.0	-304.0
chrX	124056235	124057865	124056160	124057939	JUNC00005232	172	+	75	74	-304.0	-304.0	-304.0
chrX	124057972	124063871	124057952	124063927	JUNC00005236	1	+	20	56	-304.0	-304.0	-304.0
chrX	124057972	124090860	124057932	124090916	JUNC00005235	3	+	40	56	-304.0	-304.0	-304.0
chrX	124057977	124061223	124057903	124061298	JUNC00005234	173	+	74	75	-304.0	-304.0	-304.0
chrX	124061341	124061770	124061266	124061845	JUNC00005237	179	+	75	75	-304.0	-304.0	-304.0
chrX	124061874	124062901	124061799	124062975	JUNC00005238	177	+	75	74	-304.0	-304.0	-304.0
chrX	124062994	124063115	124062920	124063189	JUNC00005239	161	+	74	74	-304.0	-304.0	-304.0
chrX	124063205	124063847	124063130	124063921	JUNC00005240	193	+	75	74	-304.0	-304.0	-304.0
chrX	124064051	124065875	124063979	124065946	JUNC00005241	133	+	72	71	-304.0	-304.0	-304.0
chrX	124065946	124066174	124065873	124066248	JUNC00005242	126	+	73	74	-304.0	-304.0	-304.0
chrX	124066262	124066355	124066188	124066430	JUNC00005243	146	+	74	75	-304.0	-304.0	-304.0
chrX	124066436	124068563	124066361	124068638	JUNC00005244	155	+	75	75	-304.0	-304.0	-304.0
chrX	124068656	124071148	124068581	124071223	JUNC00005245	140	+	75	75	-304.0	-304.0	-304.0
chrX	124071323	124076331	124071248	124076405	JUNC00005246	117	+	75	74	-304.0	-304.0	-304.0
chrX	124076471	124077956	124076397	124078031	JUNC00005247	121	+	74	75	-304.0	-304.0	-304.0
chrX	124078058	124081379	124077983	124081452	JUNC00005248	139	+	75	73	-304.0	-304.0	-304.0
chrX	124081528	124083420	124081453	124083495	JUNC00005249	130	+	75	75	-304.0	-304.0	-304.0
chrX	124083549	124086546	124083474	124086620	JUNC00005250	126	+	75	74	-304.0	-304.0	-304.0
chrX	124086770	124090574	124086695	124090649	JUNC00005251	205	+	75	75	-304.0	-304.0	-304.0
chrX	124090764	124090853	124090689	124090925	JUNC00005253	52	+	75	72	-304.0	-304.0	-304.0
chrX	124090764	124094017	124090689	124094092	JUNC00005252	219	+	75	75	-304.0	-304.0	-304.0
chrX	124090964	124094017	124090890	124094092	JUNC00005254	52	+	74	75	-304.0	-304.0	-304.0
chrX	124094144	124095371	124094069	124095446	JUNC00005255	250	+	75	75	-304.0	-304.0	-304.0
chrX	124095449	124100573	124095374	124100648	JUNC00005256	236	+	75	75	-304.0	-304.0	-304.0
chrX	124174958	124192326	124174919	124192357	JUNC00005257	1	+	39	31	-304.0	118.0	118.0
chrX	124335072	124335351	124335037	124335405	JUNC00005258	2	+	35	54	-304.0	-304.0	-304.0
chrX	124370320	124371350	124370272	124371378	JUNC00005259	1	+	48	28	-304.0	-304.0	-304.0
chrX	129447233	129448332	129447183	129448357	JUNC00005260	1	-	50	25	-304.0	-304.0	-304.0
chrX	129448443	129465519	129448411	129465563	JUNC00005261	1	-	32	44	-304.0	-304.0	-304.0
chrX	129471326	129480700	129471295	129480745	JUNC00005262	1	-	31	45	-304.0	-304.0	-304.0
chrX	129481185	129487017	129481133	129487042	JUNC00005263	2	-	52	25	-304.0	-304.0	-304.0
chrX	129490192	129491940	129490175	129491999	JUNC00005264	1	-	17	59	-304.0	-304.0	-304.0
chrX	129492093	129493039	129492067	129493077	JUNC00005266	1	-	26	38	-304.0	-304.0	-304.0
chrX	129492093	129496749	129492055	129496787	JUNC00005265	1	-	38	38	-304.0	-304.0	-304.0
chrX	129516497	129518360	129516467	129518406	JUNC00005267	1	-	30	46	-304.0	-304.0	-304.0
chrX	129540478	129540752	129540454	129540804	JUNC00005268	1	+	24	52	-304.0	-304.0	-304.0
chrX	129540823	129544957	129540762	129545018	JUNC00005269	6	+	61	61	-304.0	-304.0	-304.0
chrX	129545037	129548562	129544979	129548601	JUNC00005270	8	+	58	39	-304.0	-304.0	-304.0
chrX	129548601	129553235	129548574	129553284	JUNC00005272	2	+	27	49	-304.0	-304.0	-304.0
chrX	129548601	129557324	129548562	129557382	JUNC00005271	10	+	39	58	-304.0	-304.0	-304.0
chrX	129554446	129557324	129554408	129557362	JUNC00005273	1	+	38	38	-304.0	-304.0	-304.0
chrX	129557435	129557860	129557364	129557928	JUNC00005274	10	+	71	68	-304.0	-304.0	-304.0
chrX	129557435	129558632	129557396	129558673	JUNC00005275	4	+	39	41	-304.0	-304.0	-304.0
chrX	129557950	129558632	129557888	129558670	JUNC00005276	3	+	62	38	-304.0	-304.0	-304.0
chrX	129558753	129558839	129558721	129558885	JUNC00005277	2	+	32	46	-304.0	-304.0	-304.0
chrX	129559001	129560549	129558928	129560621	JUNC00005278	17	+	73	72	-304.0	-304.0	-304.0
chrX	129560651	129561178	129560577	129561249	JUNC00005279	28	+	74	71	-304.0	-304.0	-304.0
chrX	129561293	129562383	129561221	129562445	JUNC00005280	12	+	72	62	-304.0	-304.0	-304.0
chrX	129562500	129562598	129562451	129562625	JUNC00005281	1	+	49	27	-304.0	-304.0	-304.0
chrX	129562786	129565771	129562725	129565830	JUNC00005282	6	+	61	59	-304.0	-304.0	-304.0
chrX	129565883	129567253	129565817	129567322	JUNC00005283	4	+	66	69	-304.0	-304.0	-304.0
chrX	129567363	129569263	129567330	129569338	JUNC00005284	5	+	33	75	-304.0	-304.0	-304.0
chrX	129569399	129575139	129569343	129575203	JUNC00005285	14	+	56	64	-304.0	-304.0	-304.0
chrX	129575250	129575896	129575199	129575952	JUNC00005286	8	+	51	56	-304.0	-304.0	-304.0
chrX	129576062	129576316	129575993	129576385	JUNC00005287	10	+	69	69	-304.0	-304.0	-304.0
chrX	129576552	129579043	129576513	129579080	JUNC00005289	1	+	39	37	-304.0	-304.0	-304.0
chrX	129576552	129587001	129576484	129587073	JUNC00005288	13	+	68	72	-304.0	-304.0	-304.0
chrX	129584367	129587001	129584343	129587066	JUNC00005290	4	+	24	65	-304.0	-304.0	-304.0
chrX	129587118	129588178	129587044	129588253	JUNC00005291	14	+	74	75	-304.0	-304.0	-304.0
chrX	129588263	129588885	129588189	129588955	JUNC00005292	11	+	74	70	-304.0	-304.0	-304.0
chrX	129589013	129589844	129588947	129589914	JUNC00005293	8	+	66	70	-304.0	-304.0	-304.0
chrX	129589956	129590145	129589890	129590219	JUNC00005294	14	+	66	74	-304.0	-304.0	-304.0
chrX	129647917	129648620	129647871	129648650	JUNC00005295	1	-	46	30	-304.0	-304.0	-304.0
chrX	129756555	129759179	129756498	129759198	JUNC00005296	1	+	57	19	-304.0	-304.0	-304.0
chrX	129759240	129760511	129759190	129760537	JUNC00005298	1	+	50	26	-304.0	-304.0	-304.0
chrX	129759240	129761171	129759182	129761189	JUNC00005297	1	+	58	18	-304.0	-304.0	-304.0
chrX	129761276	129762005	129761213	129762065	JUNC00005299	6	+	63	60	-304.0	-304.0	-304.0
chrX	129762065	129762693	129762005	129762728	JUNC00005300	6	+	60	35	-304.0	-304.0	-304.0
chrX	129767692	129768290	129767662	129768352	JUNC00005301	2	+	30	62	-304.0	-304.0	-304.0
chrX	129780154	129784331	129780088	129784347	JUNC00005303	2	+	66	16	-304.0	-304.0	-304.0
chrX	129780154	129785216	129780130	129785268	JUNC00005306	1	+	24	52	-304.0	-304.0	-304.0
chrX	129780154	129787676	129780114	129787740	JUNC00005305	2	+	40	64	-304.0	-304.0	-304.0
chrX	129780154	129787974	129780079	129788049	JUNC00005302	634	+	75	75	-304.0	-304.0	-304.0
chrX	129780154	129790939	129780095	129791014	JUNC00005304	19	+	59	75	-304.0	-304.0	-304.0
chrX	129780399	129780720	129780350	129780747	JUNC00005307	1	-	49	27	-304.0	-304.0	-304.0
chrX	129788070	129788430	129787996	129788505	JUNC00005308	458	+	74	75	-304.0	-304.0	-304.0
chrX	129788070	129788464	129788006	129788538	JUNC00005309	5	+	64	74	-304.0	-304.0	-304.0
chrX	129788577	129790939	129788502	129791014	JUNC00005310	777	+	75	75	-304.0	-304.0	-304.0
chrX	129791081	129792327	129791006	129792402	JUNC00005311	727	+	75	75	-304.0	-304.0	-304.0
chrX	129791081	129792626	129791042	129792663	JUNC00005312	1	+	39	37	-304.0	-304.0	-304.0
chrX	129792476	129792626	129792401	129792701	JUNC00005313	622	+	75	75	-304.0	-304.0	-304.0
chrX	129792836	129792988	129792761	129793063	JUNC00005314	263	+	75	75	-304.0	-304.0	-304.0
chrX	129793139	129793641	129793064	129793716	JUNC00005315	401	+	75	75	-304.0	-304.0	-304.0
chrX	129793715	129794644	129793641	129794719	JUNC00005316	33	+	74	75	-304.0	-304.0	-304.0
chrX	129794252	129795516	129794178	129795588	JUNC00005317	5	+	74	72	-304.0	-304.0	-304.0
chrX	129795111	129795516	129795037	129795533	JUNC00005318	2	+	74	17	-304.0	-304.0	-304.0
chrX	129795675	129796914	129795629	129796967	JUNC00005319	4	+	46	53	-304.0	-304.0	-304.0
chrX	129806486	129810904	129806411	129810979	JUNC00005320	35	-	75	75	-304.0	-304.0	-304.0
chrX	129810986	129811405	129810936	129811431	JUNC00005322	1	-	50	26	-304.0	-304.0	-304.0
chrX	129811001	129811405	129810926	129811477	JUNC00005321	34	-	75	72	-304.0	-304.0	-304.0
chrX	129811509	129812717	129811435	129812789	JUNC00005323	27	-	74	72	-304.0	-304.0	-304.0
chrX	129812827	129813683	129812790	129813722	JUNC00005324	1	+	37	39	-304.0	-304.0	-304.0
chrX	129813725	129814657	129813676	129814732	JUNC00005325	23	-	49	75	-304.0	-304.0	-304.0
chrX	129814795	129823678	129814723	129823752	JUNC00005326	19	-	72	74	-304.0	-304.0	-304.0
chrX	129823837	129828980	129823765	129829053	JUNC00005327	20	-	72	73	-304.0	-304.0	-304.0
chrX	129829141	129841778	129829070	129841851	JUNC00005328	19	-	71	73	-304.0	-304.0	-304.0
chrX	129829141	129841918	129829088	129841993	JUNC00005329	2	-	53	75	-304.0	-304.0	-304.0
chrX	129829141	129841930	129829092	129842005	JUNC00005330	3	-	49	75	-304.0	-304.0	-304.0
chrX	129829141	129843695	129829112	129843742	JUNC00005331	1	-	29	47	-304.0	-304.0	-304.0
chrX	129842080	129843258	129842007	129843326	JUNC00005332	37	-	73	68	-304.0	-304.0	-304.0
chrX	129843326	129843695	129843257	129843761	JUNC00005333	22	-	69	66	-304.0	-304.0	-304.0
chrX	129873159	129918691	129873130	129918740	JUNC00005334	2	-	29	49	118.0	122.0	122.0
chrX	129906236	129907366	129906173	129907440	JUNC00005335	77	+	63	74	-304.0	-304.0	-304.0
chrX	129907442	129908059	129907368	129908130	JUNC00005336	84	+	74	71	-304.0	-304.0	-304.0
chrX	129907442	129911007	129907387	129911028	JUNC00005337	1	+	55	21	-304.0	-304.0	-304.0
chrX	129908130	129908669	129908057	129908735	JUNC00005338	85	+	73	66	-304.0	-304.0	-304.0
chrX	129908734	129911007	129908667	129911071	JUNC00005339	69	+	67	64	-304.0	-304.0	-304.0
chrX	129911150	129911765	129911076	129911840	JUNC00005340	75	+	74	75	-304.0	-304.0	-304.0
chrX	129911921	129912578	129911873	129912606	JUNC00005342	1	+	48	28	-304.0	-304.0	-304.0
chrX	129911921	129919174	129911847	129919249	JUNC00005341	76	+	74	75	-304.0	-304.0	-304.0
chrX	129913395	129919174	129913356	129919249	JUNC00005343	5	+	39	75	-304.0	-304.0	-304.0
chrX	129919294	129919394	129919221	129919469	JUNC00005344	68	+	73	75	-304.0	-304.0	-304.0
chrX	129919489	129920456	129919414	129920527	JUNC00005345	76	+	75	71	-304.0	-304.0	-304.0
chrX	129920580	129920674	129920505	129920738	JUNC00005346	57	+	75	64	-304.0	-304.0	-304.0
chrX	129920752	129921193	129920679	129921267	JUNC00005347	66	+	73	74	-304.0	-304.0	-304.0
chrX	129920942	129921193	129920906	129921233	JUNC00005348	1	+	36	40	-304.0	-304.0	-304.0
chrX	129921587	129924794	129921512	129924869	JUNC00005349	74	+	75	75	-304.0	-304.0	-304.0
chrX	129925195	129925897	129925163	129925941	JUNC00005351	1	+	32	44	-304.0	-304.0	-304.0
chrX	129925195	129925918	129925121	129925993	JUNC00005350	125	+	74	75	-304.0	-304.0	-304.0
chrX	129926024	129926239	129925949	129926269	JUNC00005352	2	+	75	30	-304.0	-304.0	-304.0
chrX	129926112	129926215	129926071	129926250	JUNC00005354	1	+	41	35	-304.0	-304.0	-304.0
chrX	129926112	129926239	129926037	129926314	JUNC00005353	98	+	75	75	-304.0	-304.0	-304.0
chrX	129926339	129929335	129926266	129929410	JUNC00005355	99	+	73	75	-304.0	-304.0	-304.0
chrX	129929895	129959426	129929837	129959444	JUNC00005356	1	-	58	18	-304.0	-304.0	-304.0
chrX	129970933	130036348	129970904	130036395	JUNC00005357	1	-	29	47	-304.0	-304.0	-304.0
chrX	129981333	129981672	129981286	129981738	JUNC00005358	2	+	47	66	-304.0	-304.0	-304.0
chrX	129981752	130005187	129981728	130005227	JUNC00005359	1	+	24	40	-304.0	-304.0	-304.0
chrX	129981783	130005187	129981761	130005241	JUNC00005360	1	+	22	54	-304.0	-304.0	-304.0
chrX	129982762	130005187	129982705	130005257	JUNC00005361	2	+	57	70	-304.0	-304.0	-304.0
chrX	129994022	129995242	129993992	129995288	JUNC00005362	1	+	30	46	-304.0	-304.0	-304.0
chrX	129994533	130005187	129994476	130005206	JUNC00005363	1	+	57	19	-304.0	-304.0	-304.0
chrX	130000127	130073170	130000097	130073216	JUNC00005364	1	-	30	46	-304.0	-304.0	-304.0
chrX	130005317	130010507	130005291	130010557	JUNC00005366	1	+	26	50	-304.0	-304.0	-304.0
chrX	130005317	130012577	130005256	130012647	JUNC00005365	5	+	61	70	-304.0	-304.0	-304.0
chrX	130012668	130012949	130012606	130013008	JUNC00005367	4	+	62	59	-304.0	-304.0	-304.0
chrX	130016213	130020984	130016160	130021038	JUNC00005368	10	+	53	54	-304.0	-304.0	-304.0
chrX	130021150	130022896	130021082	130022967	JUNC00005369	15	+	68	71	-304.0	-304.0	-304.0
chrX	130022977	130024989	130022903	130025052	JUNC00005370	5	+	74	63	-304.0	-304.0	-304.0
chrX	130022977	130028634	130022912	130028707	JUNC00005371	4	+	65	73	-304.0	-304.0	-304.0
chrX	130023015	130023955	130022968	130024015	JUNC00005372	2	-	47	60	-304.0	-304.0	-304.0
chrX	130024089	130024207	130024042	130024236	JUNC00005373	1	-	47	29	-304.0	-304.0	-304.0
chrX	130025379	130028634	130025311	130028706	JUNC00005374	10	+	68	72	-304.0	-304.0	-304.0
chrX	130028861	130034454	130028791	130034519	JUNC00005375	14	+	70	65	-304.0	-304.0	-304.0
chrX	130034676	130037366	130034652	130037416	JUNC00005376	1	+	24	50	-304.0	-304.0	-304.0
chrX	130039282	130050716	130039210	130050771	JUNC00005377	8	+	72	55	-304.0	-304.0	-304.0
chrX	130050794	130051859	130050720	130051925	JUNC00005378	8	+	74	66	-304.0	-304.0	-304.0
chrX	130052016	130055853	130051957	130055892	JUNC00005379	10	+	59	39	-304.0	-304.0	-304.0
chrX	130067525	130069299	130067450	130069374	JUNC00005380	80	-	75	75	-304.0	-304.0	-304.0
chrX	130069677	130071039	130069603	130071114	JUNC00005381	192	-	74	75	-304.0	-304.0	-304.0
chrX	130071232	130071335	130071157	130071410	JUNC00005382	137	-	75	75	-304.0	-304.0	-304.0
chrX	130071419	130072225	130071344	130072297	JUNC00005383	116	-	75	72	-304.0	-304.0	-304.0
chrX	130072417	130074048	130072342	130074123	JUNC00005384	171	-	75	75	-304.0	-304.0	-304.0
chrX	130074141	130074554	130074117	130074603	JUNC00005386	1	-	24	49	-304.0	-304.0	-304.0
chrX	130074141	130074580	130074071	130074654	JUNC00005385	118	-	70	74	-304.0	-304.0	-304.0
chrX	130074208	130074580	130074144	130074619	JUNC00005387	2	-	64	39	-304.0	-304.0	-304.0
chrX	130074752	130081255	130074677	130081329	JUNC00005388	89	-	75	74	-304.0	-304.0	-304.0
chrX	130074752	130086414	130074677	130086486	JUNC00005389	5	-	75	72	-304.0	-304.0	-304.0
chrX	130074752	130110324	130074679	130110366	JUNC00005390	2	-	73	42	-304.0	-304.0	-304.0
chrX	130081539	130082557	130081464	130082602	JUNC00005394	2	-	75	45	-304.0	-304.0	-304.0
chrX	130081539	130085348	130081464	130085389	JUNC00005391	5	-	75	41	-304.0	-304.0	-304.0
chrX	130081539	130086414	130081464	130086488	JUNC00005392	26	-	75	74	-304.0	-304.0	-304.0
chrX	130081539	130110324	130081464	130110356	JUNC00005393	8	-	75	32	-304.0	-304.0	-304.0
chrX	130081539	130110619	130081464	130110647	JUNC00005395	4	-	75	28	-304.0	-304.0	-304.0
chrX	130125792	130129501	130125769	130129554	JUNC00005396	1	-	23	53	-304.0	-304.0	-304.0
chrX	130129628	130129969	130129553	130130044	JUNC00005397	279	-	75	75	-304.0	-304.0	-304.0
chrX	130130033	130131674	130129969	130131749	JUNC00005398	3	-	64	75	-304.0	-304.0	-304.0
chrX	130130166	130131674	130130091	130131749	JUNC00005399	335	-	75	75	-304.0	-304.0	-304.0
chrX	130131799	130133312	130131724	130133387	JUNC00005400	226	-	75	75	-304.0	-304.0	-304.0
chrX	130133455	130136044	130133380	130136118	JUNC00005401	275	-	75	74	-304.0	-304.0	-304.0
chrX	130136185	130136642	130136110	130136717	JUNC00005402	153	-	75	75	-304.0	-304.0	-304.0
chrX	130136731	130137077	130136657	130137152	JUNC00005403	254	-	74	75	-304.0	-304.0	-304.0
chrX	130137185	130138592	130137110	130138664	JUNC00005404	205	-	75	72	-304.0	-304.0	-304.0
chrX	130138701	130139794	130138628	130139866	JUNC00005405	244	-	73	72	-304.0	-304.0	-304.0
chrX	130139871	130140532	130139796	130140607	JUNC00005406	173	-	75	75	-304.0	-304.0	-304.0
chrX	130140617	130145478	130140543	130145552	JUNC00005407	157	-	74	74	-304.0	-304.0	-304.0
chrX	130145569	130147492	130145495	130147566	JUNC00005408	228	-	74	74	-304.0	-304.0	-304.0
chrX	130147623	130147751	130147548	130147814	JUNC00005409	204	-	75	63	-304.0	-304.0	-304.0
chrX	130147876	130149468	130147801	130149543	JUNC00005410	215	-	75	75	-304.0	-304.0	-304.0
chrX	130147935	130149468	130147879	130149488	JUNC00005411	1	-	56	20	-304.0	-304.0	-304.0
chrX	130149568	130156460	130149493	130156533	JUNC00005412	207	-	75	73	-304.0	-304.0	-304.0
chrX	130149568	130165550	130149566	130165625	JUNC00005413	25	-	2	75	-304.0	-304.0	-304.0
chrX	130156603	130165550	130156528	130165625	JUNC00005414	127	-	75	75	-304.0	-304.0	-304.0
chrX	130171468	130184284	130171416	130184308	JUNC00005415	1	+	52	24	-304.0	-304.0	-304.0
chrX	130172320	130178992	130172245	130179033	JUNC00005416	5	+	75	41	-304.0	-304.0	-304.0
chrX	130172320	130184284	130172245	130184357	JUNC00005417	165	+	75	73	-304.0	-304.0	-304.0
chrX	130185461	130267023	130185439	130267073	JUNC00005418	1	-	22	50	-304.0	-304.0	-304.0
chrX	130196610	130205296	130196561	130205323	JUNC00005419	1	-	49	27	-304.0	-304.0	-304.0
chrX	130204992	130205116	130204934	130205153	JUNC00005420	6	-	58	37	-304.0	-304.0	-304.0
chrX	130205153	130205296	130205116	130205362	JUNC00005421	7	-	37	66	-304.0	-304.0	-304.0
chrX	130205415	130209652	130205352	130209709	JUNC00005422	6	-	63	57	-304.0	-304.0	-304.0
chrX	130209715	130215192	130209654	130215240	JUNC00005423	5	-	61	48	-304.0	-304.0	-304.0
chrX	130215333	130215790	130215272	130215863	JUNC00005424	10	-	61	73	-304.0	-304.0	-304.0
chrX	130216101	130220348	130216037	130220408	JUNC00005425	6	-	64	60	-304.0	-304.0	-304.0
chrX	130220480	130226758	130220424	130226831	JUNC00005426	4	-	56	73	-304.0	-304.0	-304.0
chrX	130226905	130227681	130226848	130227748	JUNC00005427	4	-	57	67	-304.0	-304.0	-304.0
chrX	130227782	130228976	130227764	130229034	JUNC00005428	1	-	18	58	-304.0	-304.0	-304.0
chrX	130229134	130230509	130229091	130230569	JUNC00005429	3	-	43	60	-304.0	-304.0	-304.0
chrX	130230727	130236213	130230652	130236271	JUNC00005430	7	-	75	58	-304.0	-304.0	-304.0
chrX	130236320	130236468	130236254	130236519	JUNC00005431	6	-	66	51	-304.0	-304.0	-304.0
chrX	130236639	130239581	130236582	130239655	JUNC00005432	5	-	57	74	-304.0	-304.0	-304.0
chrX	130239693	130243562	130239620	130243605	JUNC00005433	3	-	73	43	-304.0	-304.0	-304.0
chrX	130243699	130243799	130243633	130243865	JUNC00005434	7	-	66	66	-304.0	-304.0	-304.0
chrX	130243865	130246858	130243798	130246911	JUNC00005435	14	-	67	53	-304.0	-304.0	-304.0
chrX	130247005	130260418	130246933	130260465	JUNC00005436	8	-	72	47	-304.0	-304.0	-304.0
chrX	130260465	130268761	130260418	130268821	JUNC00005437	7	-	47	60	-304.0	-304.0	-304.0
chrX	130339976	130345181	130339929	130345254	JUNC00005438	12	+	47	73	-304.0	-304.0	-304.0
chrX	130339976	130349250	130339936	130349286	JUNC00005439	1	+	40	36	-304.0	-304.0	-304.0
chrX	130340353	130345181	130340327	130345231	JUNC00005440	1	+	26	50	-304.0	-304.0	-304.0
chrX	130345275	130346543	130345201	130346614	JUNC00005441	21	+	74	71	-304.0	-304.0	-304.0
chrX	130346691	130349250	130346625	130349324	JUNC00005442	26	+	66	74	-304.0	-304.0	-304.0
chrX	130349345	130349823	130349283	130349867	JUNC00005444	5	+	62	44	-304.0	-304.0	-304.0
chrX	130349345	130350645	130349298	130350701	JUNC00005445	9	+	47	56	-304.0	-304.0	-304.0
chrX	130349345	130358639	130349272	130358712	JUNC00005443	12	+	73	73	-304.0	-304.0	-304.0
chrX	130349867	130350645	130349823	130350701	JUNC00005446	3	+	44	56	-304.0	-304.0	-304.0
chrX	130358735	130364627	130358661	130364697	JUNC00005447	27	+	74	70	-304.0	-304.0	-304.0
chrX	130364752	130365540	130364682	130365610	JUNC00005448	17	+	70	70	-304.0	-304.0	-304.0
chrX	130365676	130371563	130365604	130371635	JUNC00005449	35	+	72	72	-304.0	-304.0	-304.0
chrX	130371644	130372908	130371573	130372981	JUNC00005450	22	+	71	73	-304.0	-304.0	-304.0
chrX	130402037	130402254	130401990	130402327	JUNC00005451	65	+	47	73	-304.0	-304.0	-304.0
chrX	130402370	130403801	130402295	130403853	JUNC00005452	125	+	75	52	-304.0	-304.0	-304.0
chrX	130403853	130409256	130403801	130409326	JUNC00005454	116	+	52	70	-304.0	-304.0	-304.0
chrX	130403853	130411347	130403801	130411367	JUNC00005453	3	+	52	20	-304.0	-304.0	-304.0
chrX	130407800	130409256	130407771	130409303	JUNC00005455	1	+	29	47	-304.0	-304.0	-304.0
chrX	130409386	130411347	130409311	130411419	JUNC00005456	98	+	75	72	-304.0	-304.0	-304.0
chrX	130411525	130412360	130411455	130412418	JUNC00005457	10	+	70	58	-304.0	-304.0	-304.0
chrX	130495748	130495849	130495713	130495890	JUNC00005458	1	?	35	41	-304.0	-304.0	-304.0
chrX	130625445	130627957	130625380	130628028	JUNC00005459	17	-	65	71	-304.0	-304.0	-304.0
chrX	130628043	130631467	130627972	130631537	JUNC00005460	23	-	71	70	-304.0	-304.0	-304.0
chrX	130631576	130634983	130631501	130635054	JUNC00005461	25	-	75	71	-304.0	-304.0	-304.0
chrX	130635091	130637228	130635016	130637302	JUNC00005462	33	-	75	74	-304.0	-304.0	-304.0
chrX	130637404	130656580	130637340	130656613	JUNC00005464	4	-	64	33	-304.0	-304.0	-304.0
chrX	130637410	130656580	130637337	130656650	JUNC00005463	25	-	73	70	-304.0	-304.0	-304.0
chrX	130656695	130665642	130656630	130665711	JUNC00005465	13	-	65	69	-304.0	-304.0	-304.0
chrX	130665749	130667529	130665679	130667602	JUNC00005466	15	-	70	73	-304.0	-304.0	-304.0
chrX	130667742	130669964	130667667	130670023	JUNC00005467	15	-	75	59	-304.0	-304.0	-304.0
chrX	130667742	130679541	130667667	130679601	JUNC00005468	2	-	75	60	-304.0	-304.0	-304.0
chrX	130670198	130679541	130670131	130679613	JUNC00005469	27	-	67	72	-304.0	-304.0	-304.0
chrX	130670198	130688862	130670167	130688907	JUNC00005470	1	-	31	45	-304.0	-304.0	-304.0
chrX	130679748	130688862	130679676	130688936	JUNC00005471	21	-	72	74	-304.0	-304.0	-304.0
chrX	130689018	130703119	130688943	130703187	JUNC00005472	16	-	75	68	-304.0	-304.0	-304.0
chrX	130703254	130783546	130703182	130783617	JUNC00005473	7	-	72	71	-304.0	-304.0	-304.0
chrX	130703254	130901683	130703190	130901731	JUNC00005474	5	-	64	48	-304.0	-304.0	-304.0
chrX	130709331	130783546	130709284	130783613	JUNC00005476	2	-	47	67	-304.0	-304.0	-304.0
chrX	130709331	130901683	130709299	130901727	JUNC00005477	1	-	32	44	-304.0	-304.0	-304.0
chrX	130730007	130783546	130729974	130783601	JUNC00005478	2	-	33	55	-304.0	-304.0	-304.0
chrX	130783690	130784371	130783667	130784424	JUNC00005480	1	-	23	53	-304.0	-304.0	-304.0
chrX	130783690	130901683	130783627	130901733	JUNC00005479	15	-	63	50	-304.0	-304.0	-304.0
chrX	130784430	130901683	130784397	130901726	JUNC00005481	1	-	33	43	-304.0	-304.0	-304.0
chrX	130901731	130903048	130901683	130903122	JUNC00005475	13	-	48	74	-304.0	-304.0	-304.0
chrX	131085736	131085912	131085695	131085947	JUNC00005482	1	+	41	35	-304.0	-304.0	-304.0
chrX	131278134	131278460	131278090	131278492	JUNC00005483	1	-	44	32	-304.0	-304.0	-304.0
chrX	131661705	131663910	131661686	131663967	JUNC00005484	1	-	19	57	-304.0	-304.0	-304.0
chrX	131692636	131695843	131692608	131695891	JUNC00005485	1	-	28	48	-304.0	-304.0	-304.0
chrX	131703518	131709497	131703514	131709556	JUNC00005486	1	-	4	59	-304.0	-304.0	-304.0
chrX	131709556	131711650	131709497	131711697	JUNC00005487	2	-	59	47	-304.0	-304.0	-304.0
chrX	131711720	131743095	131711684	131743135	JUNC00005488	1	-	36	40	-304.0	-304.0	-304.0
chrX	131711720	131749305	131711695	131749367	JUNC00005489	2	-	25	62	-304.0	-304.0	-304.0
chrX	131749458	131755597	131749401	131755662	JUNC00005490	7	-	57	65	-304.0	-304.0	-304.0
chrX	131755746	131756610	131755683	131756680	JUNC00005491	8	-	63	70	-304.0	-304.0	-304.0
chrX	131756709	131768548	131756655	131768623	JUNC00005492	11	-	54	75	-304.0	-304.0	-304.0
chrX	131768696	131777622	131768638	131777693	JUNC00005494	4	-	58	71	-304.0	-304.0	-304.0
chrX	131768696	131783886	131768631	131783961	JUNC00005493	5	-	65	75	-304.0	-304.0	-304.0
chrX	131777744	131783886	131777672	131783943	JUNC00005495	4	-	72	57	-304.0	-304.0	-304.0
chrX	131784039	131785156	131783980	131785230	JUNC00005496	7	-	59	74	-304.0	-304.0	-304.0
chrX	131785258	131794296	131785212	131794326	JUNC00005497	1	-	46	30	-304.0	-304.0	-304.0
chrX	131794115	131794296	131794060	131794338	JUNC00005498	2	-	55	42	-304.0	-304.0	-304.0
chrX	131794466	131825221	131794426	131825257	JUNC00005499	1	-	40	36	-304.0	-304.0	-304.0
chrX	131796331	131804971	131796259	131805017	JUNC00005500	5	-	72	46	-304.0	-304.0	-304.0
chrX	131796331	131825221	131796316	131825282	JUNC00005501	1	-	15	61	-304.0	-304.0	-304.0
chrX	131805037	131825221	131804975	131825288	JUNC00005502	7	-	62	67	-304.0	-304.0	-304.0
chrX	131807268	131812317	131807240	131812365	JUNC00005503	1	+	28	48	-304.0	-304.0	-304.0
chrX	131824315	131825221	131824278	131825260	JUNC00005504	1	-	37	39	-304.0	-304.0	-304.0
chrX	131825365	131830291	131825291	131830365	JUNC00005505	15	-	74	74	-304.0	-304.0	-304.0
chrX	132022040	132022726	132021985	132022747	JUNC00005506	1	-	55	21	-304.0	-304.0	-304.0
chrX	132023407	132023507	132023354	132023570	JUNC00005507	9	+	53	63	-304.0	-304.0	-304.0
chrX	132023659	132054630	132023584	132054705	JUNC00005508	74	+	75	75	-304.0	-304.0	-304.0
chrX	132023659	132063432	132023621	132063491	JUNC00005509	2	+	38	59	-304.0	-304.0	-304.0
chrX	132053781	132054630	132053727	132054652	JUNC00005510	1	+	54	22	-304.0	-304.0	-304.0
chrX	132054861	132063432	132054786	132063489	JUNC00005511	112	+	75	57	-304.0	-304.0	-304.0
chrX	132054861	132068214	132054819	132068248	JUNC00005512	1	+	42	34	-304.0	-304.0	-304.0
chrX	132063489	132068083	132063435	132068105	JUNC00005514	1	+	54	22	-304.0	-304.0	-304.0
chrX	132063489	132068214	132063431	132068289	JUNC00005513	156	+	58	75	-304.0	-304.0	-304.0
chrX	132068323	132068411	132068248	132068486	JUNC00005515	201	+	75	75	-304.0	-304.0	-304.0
chrX	132068569	132069477	132068494	132069552	JUNC00005516	176	+	75	75	-304.0	-304.0	-304.0
chrX	132068569	132071068	132068494	132071137	JUNC00005517	7	+	75	69	-304.0	-304.0	-304.0
chrX	132069663	132071068	132069588	132071143	JUNC00005518	133	+	75	75	-304.0	-304.0	-304.0
chrX	132071217	132072267	132071143	132072342	JUNC00005519	172	+	74	75	-304.0	-304.0	-304.0
chrX	132071217	132072965	132071195	132073019	JUNC00005520	1	+	22	54	-304.0	-304.0	-304.0
chrX	132072361	132072812	132072286	132072875	JUNC00005521	188	+	75	63	-304.0	-304.0	-304.0
chrX	132072875	132072956	132072812	132073030	JUNC00005522	223	+	63	74	-304.0	-304.0	-304.0
chrX	132073093	132074134	132073019	132074208	JUNC00005523	125	+	74	74	-304.0	-304.0	-304.0
chrX	132073093	132074196	132073042	132074221	JUNC00005524	1	+	51	25	-304.0	-304.0	-304.0
chrX	132204793	132205007	132204768	132205058	JUNC00005525	1	?	25	51	-304.0	-304.0	-304.0
chrX	132205587	132214133	132205512	132214208	JUNC00005526	206	-	75	75	-304.0	-304.0	-304.0
chrX	132214446	132214534	132214371	132214536	JUNC00005527	4	-	75	2	-304.0	-304.0	-304.0
chrX	132214446	132216995	132214371	132217070	JUNC00005528	159	-	75	75	-304.0	-304.0	-304.0
chrX	132214575	132216995	132214574	132217070	JUNC00005529	3	-	1	75	-304.0	-304.0	-304.0
chrX	132217141	132217277	132217090	132217302	JUNC00005531	1	-	51	25	-304.0	-304.0	-304.0
chrX	132217156	132217277	132217081	132217345	JUNC00005530	27	-	75	68	-304.0	-304.0	-304.0
chrX	132217367	132218231	132217292	132218232	JUNC00005532	1	-	75	1	-304.0	-304.0	-304.0
chrX	132218837	132239619	132218788	132239686	JUNC00005533	3	+	49	67	-304.0	-304.0	-304.0
chrX	132234682	132239619	132234647	132239660	JUNC00005534	1	+	35	41	-304.0	-304.0	-304.0
chrX	132239711	132429812	132239669	132429846	JUNC00005535	1	+	42	34	-304.0	-304.0	-304.0
chrX	132379677	132381358	132379622	132381421	JUNC00005537	5	-	55	63	-304.0	-304.0	-304.0
chrX	132379677	132382177	132379602	132382252	JUNC00005536	33	-	75	75	-304.0	-304.0	-304.0
chrX	132381432	132382177	132381361	132382249	JUNC00005538	13	-	71	72	-304.0	-304.0	-304.0
chrX	132382272	132384662	132382198	132384701	JUNC00005539	38	-	74	39	-304.0	-304.0	-304.0
chrX	132384698	132386660	132384662	132386731	JUNC00005540	43	-	36	71	-304.0	-304.0	-304.0
chrX	132386811	132390846	132386736	132390917	JUNC00005541	54	-	75	71	-304.0	-304.0	-304.0
chrX	132391083	132392142	132391011	132392215	JUNC00005542	51	-	72	73	-304.0	-304.0	-304.0
chrX	132392334	132406227	132392259	132406297	JUNC00005543	50	-	75	70	-304.0	-304.0	-304.0
chrX	132401607	132406227	132401566	132406262	JUNC00005544	1	-	41	35	-304.0	-304.0	-304.0
chrX	132406392	132437898	132406350	132437943	JUNC00005547	2	-	42	45	-304.0	-304.0	-304.0
chrX	132406392	132439434	132406322	132439509	JUNC00005545	14	-	70	75	-304.0	-304.0	-304.0
chrX	132406392	132488850	132406331	132488923	JUNC00005546	8	-	61	73	-304.0	-304.0	-304.0
chrX	132437943	132439434	132437898	132439465	JUNC00005548	2	-	45	31	-304.0	-304.0	-304.0
chrX	132440314	132441398	132440247	132441445	JUNC00005550	3	-	67	47	-304.0	-304.0	-304.0
chrX	132440314	132488850	132440243	132488902	JUNC00005549	6	-	71	52	-304.0	-304.0	-304.0
chrX	133303069	133303165	133302995	133303240	JUNC00005551	70	-	74	75	-304.0	-304.0	-304.0
chrX	133303341	133304724	133303267	133304799	JUNC00005552	96	-	74	75	-304.0	-304.0	-304.0
chrX	133304861	133305771	133304791	133305841	JUNC00005553	53	-	70	70	-304.0	-304.0	-304.0
chrX	133305918	133306023	133305843	133306098	JUNC00005554	50	-	75	75	-304.0	-304.0	-304.0
chrX	133306154	133311257	133306085	133311328	JUNC00005555	57	-	69	71	-304.0	-304.0	-304.0
chrX	133311423	133324144	133311348	133324219	JUNC00005556	65	-	75	75	-304.0	-304.0	-304.0
chrX	133320559	133408667	133320538	133408721	JUNC00005557	1	+	21	54	-304.0	-304.0	-304.0
chrX	133324536	133339182	133324461	133339255	JUNC00005558	37	-	75	73	-304.0	-304.0	-304.0
chrX	133339341	133414392	133339289	133414416	JUNC00005560	1	-	52	24	-304.0	-304.0	-304.0
chrX	133339341	133414805	133339269	133414878	JUNC00005559	38	-	72	73	-304.0	-304.0	-304.0
chrX	133660994	133735788	133660959	133735829	JUNC00005561	1	-	35	41	-304.0	-304.0	-304.0
chrX	133671201	133671239	133671167	133671281	JUNC00005562	1	?	34	42	-304.0	-304.0	-304.0
chrX	133671225	133671287	133671171	133671309	JUNC00005563	1	?	54	22	-304.0	-304.0	-304.0
chrX	134366957	134417781	134366927	134417824	JUNC00005564	1	-	30	43	128.0	132.0	132.0
chrX	134373467	134377571	134373397	134377646	JUNC00005565	106	+	70	75	-304.0	-304.0	-304.0
chrX	134373678	134377571	134373642	134377611	JUNC00005566	1	+	36	40	-304.0	-304.0	-304.0
chrX	134377755	134378004	134377685	134378079	JUNC00005567	74	+	70	75	-304.0	-304.0	-304.0
chrX	134377755	134393500	134377707	134393558	JUNC00005568	2	+	48	58	-304.0	-304.0	-304.0
chrX	134378106	134393500	134378031	134393575	JUNC00005569	86	+	75	75	-304.0	-304.0	-304.0
chrX	134380346	134386616	134380313	134386657	JUNC00005570	1	-	33	41	-304.0	-304.0	-304.0
chrX	134393634	134393908	134393561	134393967	JUNC00005571	147	+	73	59	-304.0	-304.0	-304.0
chrX	134393952	134413487	134393908	134413561	JUNC00005572	38	+	44	74	-304.0	-304.0	-304.0
chrX	134393952	134413490	134393908	134413565	JUNC00005573	116	+	44	75	-304.0	-304.0	-304.0
chrX	134413657	134413822	134413583	134413897	JUNC00005574	90	+	74	75	-304.0	-304.0	-304.0
chrX	134413966	134415015	134413895	134415090	JUNC00005575	94	+	71	75	-304.0	-304.0	-304.0
chrX	134415120	134417168	134415045	134417243	JUNC00005576	98	+	75	75	-304.0	-304.0	-304.0
chrX	134417302	134425200	134417227	134425275	JUNC00005577	132	+	75	75	-304.0	-304.0	-304.0
chrX	134425330	134425660	134425255	134425727	JUNC00005578	99	+	75	67	-304.0	-304.0	-304.0
chrX	134460338	134473358	134460265	134473433	JUNC00005579	126	+	73	75	-304.0	-304.0	-304.0
chrX	134473465	134475180	134473390	134475255	JUNC00005580	247	+	75	75	-304.0	-304.0	-304.0
chrX	134475364	134486464	134475289	134486530	JUNC00005581	351	+	75	66	-304.0	-304.0	-304.0
chrX	134486530	134490187	134486463	134490224	JUNC00005582	369	+	67	37	-304.0	-304.0	-304.0
chrX	134490205	134491385	134490188	134491444	JUNC00005584	1	+	17	59	-304.0	-304.0	-304.0
chrX	134490205	134493507	134490184	134493582	JUNC00005583	383	+	21	75	-304.0	-304.0	-304.0
chrX	134493590	134498389	134493515	134498436	JUNC00005585	366	+	75	47	-304.0	-304.0	-304.0
chrX	134498436	134498607	134498388	134498681	JUNC00005586	399	+	48	74	-304.0	-304.0	-304.0
chrX	134498436	134500029	134498401	134500070	JUNC00005587	1	+	35	41	-304.0	-304.0	-304.0
chrX	134498684	134500029	134498609	134500104	JUNC00005588	393	+	75	75	-304.0	-304.0	-304.0
chrX	134498684	134513934	134498627	134514002	JUNC00005589	6	+	57	68	-304.0	-304.0	-304.0
chrX	134514051	134514444	134513988	134514469	JUNC00005590	2	+	63	25	-304.0	-304.0	-304.0
chrX	134515118	134517193	134515097	134517248	JUNC00005591	1	-	21	55	-304.0	-304.0	-304.0
chrX	134524899	134525034	134524858	134525069	JUNC00005592	1	-	41	35	-304.0	-304.0	-304.0
chrX	134543931	134544713	134543889	134544747	JUNC00005593	1	-	42	34	-304.0	-304.0	-304.0
chrX	134544797	134546551	134544723	134546620	JUNC00005594	2	-	74	69	-304.0	-304.0	-304.0
chrX	134548120	134548475	134548072	134548503	JUNC00005595	1	-	48	28	-304.0	-304.0	-304.0
chrX	134748265	134784016	134748236	134784063	JUNC00005596	1	+	29	47	-304.0	-304.0	-304.0
chrX	134755994	134811530	134755967	134811575	JUNC00005597	1	+	27	45	116.0	-304.0	116.0
chrX	134771354	134771442	134771282	134771517	JUNC00005598	3	-	72	75	-304.0	-304.0	-304.0
chrX	134771354	134772142	134771309	134772216	JUNC00005600	3	-	45	74	-304.0	-304.0	-304.0
chrX	134771354	134781820	134771286	134781892	JUNC00005599	34	-	68	72	-304.0	-304.0	-304.0
chrX	134771354	134793814	134771317	134793853	JUNC00005601	1	-	37	39	-304.0	-304.0	-304.0
chrX	134772283	134781820	134772208	134781891	JUNC00005602	81	-	75	71	-304.0	-304.0	-304.0
chrX	134781917	134785885	134781842	134785953	JUNC00005603	150	-	75	68	-304.0	-304.0	-304.0
chrX	134785947	134787471	134785884	134787535	JUNC00005604	75	-	63	64	-304.0	-304.0	-304.0
chrX	134785950	134787471	134785884	134787534	JUNC00005605	125	-	66	63	-304.0	-304.0	-304.0
chrX	134787533	134788729	134787471	134788803	JUNC00005606	165	-	62	74	-304.0	-304.0	-304.0
chrX	134788831	134789084	134788760	134789140	JUNC00005607	134	-	71	56	-304.0	-304.0	-304.0
chrX	134788831	134789222	134788806	134789266	JUNC00005608	1	-	25	44	-304.0	-304.0	-304.0
chrX	134789139	134789222	134789083	134789267	JUNC00005610	168	-	56	45	-304.0	-304.0	-304.0
chrX	134789266	134789579	134789222	134789636	JUNC00005609	66	-	44	57	-304.0	-304.0	-304.0
chrX	134789266	134793802	134789222	134793870	JUNC00005612	15	-	44	68	-304.0	-304.0	-304.0
chrX	134789266	134793814	134789222	134793889	JUNC00005611	71	-	44	75	-304.0	-304.0	-304.0
chrX	134789636	134793802	134789579	134793866	JUNC00005614	9	-	57	64	-304.0	-304.0	-304.0
chrX	134789636	134793814	134789579	134793889	JUNC00005613	56	-	57	75	-304.0	-304.0	-304.0
chrX	134793893	134796107	134793818	134796182	JUNC00005615	128	-	75	75	-304.0	-304.0	-304.0
chrX	134796256	134797120	134796225	134797165	JUNC00005616	1	-	31	45	-304.0	-304.0	-304.0
chrX	134796461	134796486	134796440	134796541	JUNC00005617	1	?	21	55	102.0	102.0	102.0
chrX	134796864	134804100	134796790	134804149	JUNC00005618	3	+	74	49	-304.0	-304.0	-304.0
chrX	134800230	134843129	134800211	134843186	JUNC00005619	1	+	19	57	-304.0	-304.0	-304.0
chrX	134804246	134807539	134804184	134807610	JUNC00005620	11	+	62	71	-304.0	-304.0	-304.0
chrX	134807341	134807539	134807289	134807612	JUNC00005621	11	+	52	73	-304.0	-304.0	-304.0
chrX	134807708	134809186	134807633	134809247	JUNC00005622	5	+	75	61	-304.0	-304.0	-304.0
chrX	134807708	134814770	134807637	134814842	JUNC00005623	21	+	71	72	-304.0	-304.0	-304.0
chrX	134814849	134821326	134814804	134821399	JUNC00005626	6	+	45	73	-304.0	-304.0	-304.0
chrX	134814849	134821468	134814800	134821513	JUNC00005625	2	+	49	45	-304.0	-304.0	-304.0
chrX	134814849	134829225	134814778	134829297	JUNC00005624	12	+	71	72	-304.0	-304.0	-304.0
chrX	134821578	134829225	134821540	134829263	JUNC00005628	1	+	38	38	-304.0	-304.0	-304.0
chrX	134829282	134832944	134829225	134832988	JUNC00005627	7	+	57	44	-304.0	-304.0	-304.0
chrX	134829282	134845204	134829259	134845249	JUNC00005629	1	+	23	45	-304.0	-304.0	-304.0
chrX	134833128	134833570	134833113	134833631	JUNC00005630	1	+	15	61	-304.0	-304.0	-304.0
chrX	134834226	134836889	134834181	134836920	JUNC00005631	1	+	45	31	-304.0	-304.0	-304.0
chrX	134835796	134838726	134835744	134838750	JUNC00005632	1	+	52	24	-304.0	-304.0	-304.0
chrX	134837334	134838726	134837318	134838786	JUNC00005633	1	+	16	60	-304.0	-304.0	-304.0
chrX	134839603	134845204	134839574	134845248	JUNC00005634	1	+	29	44	-304.0	-304.0	-304.0
chrX	134844193	134845204	134844136	134845223	JUNC00005636	1	+	57	19	-304.0	-304.0	-304.0
chrX	134845248	134845346	134845204	134845389	JUNC00005635	2	+	44	43	-304.0	-304.0	-304.0
chrX	134845401	134847382	134845357	134847437	JUNC00005637	4	+	44	55	-304.0	-304.0	-304.0
chrX	134847475	134852799	134847441	134852830	JUNC00005639	1	+	34	31	-304.0	-304.0	-304.0
chrX	134847475	134854090	134847437	134854128	JUNC00005638	1	+	38	38	-304.0	-304.0	-304.0
chrX	134847971	134849166	134847916	134849187	JUNC00005640	1	+	55	21	-304.0	-304.0	-304.0
chrX	134849228	134852799	134849202	134852849	JUNC00005641	1	+	26	50	-304.0	-304.0	-304.0
chrX	134852896	134854090	134852849	134854165	JUNC00005642	6	+	47	75	-304.0	-304.0	-304.0
chrX	134889192	134891478	134889128	134891548	JUNC00005643	12	-	64	70	-304.0	-304.0	-304.0
chrX	134889192	134896816	134889159	134896859	JUNC00005644	1	-	33	43	-304.0	-304.0	-304.0
chrX	134891640	134896816	134891567	134896887	JUNC00005645	11	-	73	71	-304.0	-304.0	-304.0
chrX	134897034	134899089	134896960	134899161	JUNC00005646	30	-	74	72	-304.0	-304.0	-304.0
chrX	134899165	134899279	134899091	134899343	JUNC00005647	20	-	74	64	-304.0	-304.0	-304.0
chrX	134899534	134915181	134899461	134915242	JUNC00005648	15	-	73	61	-304.0	-304.0	-304.0
chrX	134899691	134903474	134899663	134903522	JUNC00005649	1	+	28	48	-304.0	-304.0	-304.0
chrX	134904858	134915181	134904827	134915230	JUNC00005650	2	-	31	49	-304.0	-304.0	-304.0
chrX	135021573	135033170	135021546	135033243	JUNC00005651	3	+	27	73	-304.0	-304.0	-304.0
chrX	135033205	135034668	135033187	135034726	JUNC00005652	1	+	18	58	-304.0	-304.0	-304.0
chrX	135034741	135034880	135034712	135034927	JUNC00005653	1	+	29	47	-304.0	-304.0	-304.0
chrX	135051368	135051916	135051295	135051988	JUNC00005654	17	-	73	72	-304.0	-304.0	-304.0
chrX	135051443	135051916	135051398	135051988	JUNC00005655	3	-	45	72	-304.0	-304.0	-304.0
chrX	135051476	135051916	135051407	135051941	JUNC00005656	3	-	69	25	-304.0	-304.0	-304.0
chrX	135287846	135291008	135287773	135291083	JUNC00005657	17	-	73	75	-304.0	-304.0	-304.0
chrX	135291135	135291471	135291062	135291539	JUNC00005658	22	-	73	68	-304.0	-304.0	-304.0
chrX	135291563	135292280	135291494	135292355	JUNC00005659	15	-	69	75	-304.0	-304.0	-304.0
chrX	135291627	135292280	135291597	135292326	JUNC00005660	1	-	30	46	-304.0	-304.0	-304.0
chrX	135292473	135293729	135292403	135293801	JUNC00005661	19	-	70	72	-304.0	-304.0	-304.0
chrX	135292473	135295767	135292454	135295824	JUNC00005662	1	-	19	57	-304.0	-304.0	-304.0
chrX	135294258	135295767	135294200	135295824	JUNC00005663	7	-	58	57	-304.0	-304.0	-304.0
chrX	135294258	135341767	135294229	135341814	JUNC00005664	1	-	29	47	-304.0	-304.0	-304.0
chrX	135296039	135341767	135295966	135341812	JUNC00005665	5	-	73	45	-304.0	-304.0	-304.0
chrX	135296039	135343260	135295981	135343278	JUNC00005666	2	-	58	18	-304.0	-304.0	-304.0
chrX	135330459	135341767	135330403	135341797	JUNC00005667	2	-	56	30	-304.0	-304.0	-304.0
chrX	135341954	135343260	135341934	135343316	JUNC00005668	1	-	20	56	-304.0	-304.0	-304.0
chrX	135347472	135348753	135347408	135348809	JUNC00005669	3	+	64	56	-304.0	-304.0	-304.0
chrX	135347472	135349109	135347432	135349174	JUNC00005670	3	+	40	65	-304.0	-304.0	-304.0
chrX	135349314	135359891	135349246	135359955	JUNC00005671	4	+	68	64	-304.0	-304.0	-304.0
chrX	135360005	135360192	135359948	135360211	JUNC00005672	1	+	57	19	-304.0	-304.0	-304.0
chrX	135521103	135521240	135521036	135521315	JUNC00005673	32	+	67	75	-304.0	-304.0	-304.0
chrX	135521318	135545422	135521243	135545494	JUNC00005674	38	+	75	72	-304.0	-304.0	-304.0
chrX	135522109	135545422	135522080	135545469	JUNC00005675	1	+	29	47	-304.0	-304.0	-304.0
chrX	135522260	135545422	135522217	135545455	JUNC00005676	1	+	43	33	-304.0	-304.0	-304.0
chrX	135545498	135546379	135545459	135546416	JUNC00005677	1	+	39	37	-304.0	-304.0	-304.0
chrX	135545572	135546379	135545497	135546452	JUNC00005678	37	+	75	73	-304.0	-304.0	-304.0
chrX	135545572	135546428	135545549	135546469	JUNC00005679	2	+	23	41	-304.0	-304.0	-304.0
chrX	135545587	135546379	135545549	135546417	JUNC00005681	1	+	38	38	-304.0	-304.0	-304.0
chrX	135546469	135546701	135546396	135546776	JUNC00005680	58	+	73	75	-304.0	-304.0	-304.0
chrX	135546469	135546772	135546437	135546817	JUNC00005682	2	+	32	45	-304.0	-304.0	-304.0
chrX	135546885	135547136	135546813	135547209	JUNC00005683	35	+	72	73	-304.0	-304.0	-304.0
chrX	135547265	135549641	135547195	135549715	JUNC00005684	39	+	70	74	-304.0	-304.0	-304.0
chrX	135549805	135551993	135549730	135552067	JUNC00005685	43	+	75	74	-304.0	-304.0	-304.0
chrX	135552146	135553506	135552095	135553555	JUNC00005688	2	+	51	49	-304.0	-304.0	-304.0
chrX	135552146	135556167	135552072	135556240	JUNC00005686	68	+	74	73	-304.0	-304.0	-304.0
chrX	135552146	135569336	135552090	135569407	JUNC00005687	3	+	56	71	-304.0	-304.0	-304.0
chrX	135556300	135569336	135556227	135569409	JUNC00005689	28	+	73	73	-304.0	-304.0	-304.0
chrX	135569431	135570435	135569356	135570507	JUNC00005690	20	+	75	72	-304.0	-304.0	-304.0
chrX	135569431	135572814	135569370	135572884	JUNC00005691	12	+	61	70	-304.0	-304.0	-304.0
chrX	135569583	135570435	135569551	135570479	JUNC00005692	1	+	32	44	-304.0	-304.0	-304.0
chrX	135570546	135572814	135570486	135572885	JUNC00005693	25	+	60	71	-304.0	-304.0	-304.0
chrX	135573033	135573938	135572958	135574011	JUNC00005694	72	+	75	73	-304.0	-304.0	-304.0
chrX	135574062	135575083	135573987	135575155	JUNC00005695	61	+	75	72	-304.0	-304.0	-304.0
chrX	135575226	135577192	135575151	135577267	JUNC00005696	73	+	75	75	-304.0	-304.0	-304.0
chrX	135577295	135579787	135577231	135579858	JUNC00005697	23	+	64	71	-304.0	-304.0	-304.0
chrX	135577336	135579787	135577292	135579819	JUNC00005698	1	+	44	32	-304.0	-304.0	-304.0
chrX	135577427	135579787	135577352	135579856	JUNC00005699	29	+	75	69	-304.0	-304.0	-304.0
chrX	135580162	135581049	135580090	135581123	JUNC00005700	65	+	72	74	-304.0	-304.0	-304.0
chrX	135581143	135581527	135581075	135581599	JUNC00005701	58	+	68	72	-304.0	-304.0	-304.0
chrX	135581143	135582240	135581090	135582275	JUNC00005702	2	+	53	35	-304.0	-304.0	-304.0
chrX	135581564	135582240	135581535	135582287	JUNC00005703	1	+	29	47	-304.0	-304.0	-304.0
chrX	135581631	135582240	135581576	135582315	JUNC00005704	2	+	55	75	-304.0	-304.0	-304.0
chrX	135581631	135582242	135581600	135582287	JUNC00005705	1	+	31	45	-304.0	-304.0	-304.0
chrX	135719109	135721027	135719075	135721069	JUNC00005706	1	+	34	42	-304.0	-304.0	-304.0
chrX	135721276	135721657	135721204	135721726	JUNC00005707	10	+	72	69	-304.0	-304.0	-304.0
chrX	135721751	135722975	135721686	135723048	JUNC00005708	11	+	65	73	-304.0	-304.0	-304.0
chrX	135761727	135762107	135761653	135762179	JUNC00005709	20	-	74	72	-304.0	-304.0	-304.0
chrX	135779011	135779392	135778937	135779464	JUNC00005710	19	-	74	72	-304.0	-304.0	-304.0
chrX	135796273	135796654	135796199	135796726	JUNC00005711	12	-	74	72	-304.0	-304.0	-304.0
chrX	135813547	135813927	135813491	135813947	JUNC00005712	1	-	56	20	-304.0	-304.0	-304.0
chrX	135830815	135831196	135830741	135831268	JUNC00005713	12	-	74	72	-304.0	-304.0	-304.0
chrX	135965183	135967389	135965112	135967464	JUNC00005714	48	-	71	75	-304.0	-304.0	-304.0
chrX	135967493	135971057	135967420	135971110	JUNC00005715	21	-	73	53	-304.0	-304.0	-304.0
chrX	135971110	135973596	135971057	135973665	JUNC00005716	24	-	53	69	-304.0	-304.0	-304.0
chrX	135985472	135985602	135985450	135985653	JUNC00005717	1	+	22	51	-304.0	-304.0	-304.0
chrX	135994889	135998107	135994871	135998165	JUNC00005718	1	+	18	58	-304.0	-304.0	-304.0
chrX	135994985	135998107	135994917	135998176	JUNC00005719	12	+	68	69	-304.0	-304.0	-304.0
chrX	135998185	135998481	135998111	135998555	JUNC00005720	25	+	74	74	-304.0	-304.0	-304.0
chrX	135998558	135998855	135998486	135998925	JUNC00005721	25	+	72	70	-304.0	-304.0	-304.0
chrX	135998968	136002107	135998895	136002182	JUNC00005722	28	+	73	75	-304.0	-304.0	-304.0
chrX	136002213	136010441	136002139	136010516	JUNC00005723	34	+	74	75	-304.0	-304.0	-304.0
chrX	136013054	136013348	136012981	136013423	JUNC00005724	36	+	73	75	-304.0	-304.0	-304.0
chrX	136013437	136016644	136013364	136016710	JUNC00005725	17	+	73	66	-304.0	-304.0	-304.0
chrX	136016758	136022585	136016694	136022654	JUNC00005726	21	+	64	69	-304.0	-304.0	-304.0
chrX	136022697	136024329	136022627	136024402	JUNC00005727	22	+	70	73	-304.0	-304.0	-304.0
chrX	136024483	136030131	136024409	136030162	JUNC00005728	15	+	74	31	-304.0	-304.0	-304.0
chrX	136028975	136030131	136028918	136030150	JUNC00005730	1	+	57	19	-304.0	-304.0	-304.0
chrX	136030162	136033413	136030129	136033481	JUNC00005729	24	+	33	68	-304.0	-304.0	-304.0
chrX	136033493	136040075	136033420	136040143	JUNC00005731	29	+	73	68	-304.0	-304.0	-304.0
chrX	136040181	136044451	136040108	136044526	JUNC00005732	30	+	73	75	-304.0	-304.0	-304.0
chrX	136075090	136092745	136075063	136092787	JUNC00005733	1	+	27	42	-304.0	-304.0	-304.0
chrX	136147628	136169906	136147588	136169975	JUNC00005734	7	+	40	69	-304.0	-304.0	-304.0
chrX	136169980	136206406	136169906	136206481	JUNC00005735	25	+	74	75	-304.0	-304.0	-304.0
chrX	136206588	136207015	136206516	136207089	JUNC00005736	35	+	72	74	-304.0	-304.0	-304.0
chrX	136207190	136207791	136207117	136207866	JUNC00005737	49	+	73	75	-304.0	-304.0	-304.0
chrX	136207961	136208454	136207886	136208529	JUNC00005738	54	+	75	75	-304.0	-304.0	-304.0
chrX	136207961	136209870	136207886	136209945	JUNC00005739	7	+	75	75	-304.0	-304.0	-304.0
chrX	136208641	136209870	136208568	136209945	JUNC00005740	33	+	73	75	-304.0	-304.0	-304.0
chrX	136217258	136219397	136217204	136219419	JUNC00005741	1	-	54	22	-304.0	-304.0	-304.0
chrX	136218493	136219397	136218422	136219469	JUNC00005742	50	-	71	72	-304.0	-304.0	-304.0
chrX	136219495	136219592	136219423	136219667	JUNC00005743	60	-	72	75	-304.0	-304.0	-304.0
chrX	136219671	136220764	136219601	136220837	JUNC00005744	42	-	70	73	-304.0	-304.0	-304.0
chrX	136219671	136222392	136219605	136222443	JUNC00005745	4	-	66	51	-304.0	-304.0	-304.0
chrX	136220963	136222392	136220889	136222466	JUNC00005746	48	-	74	74	-304.0	-304.0	-304.0
chrX	136222486	136224826	136222419	136224882	JUNC00005747	40	-	67	56	-304.0	-304.0	-304.0
chrX	136224880	136225908	136224826	136225978	JUNC00005748	34	-	54	70	-304.0	-304.0	-304.0
chrX	136226013	136227283	136225948	136227355	JUNC00005749	45	-	65	72	-304.0	-304.0	-304.0
chrX	136227431	136228622	136227361	136228696	JUNC00005750	38	-	70	74	-304.0	-304.0	-304.0
chrX	136228758	136230384	136228693	136230454	JUNC00005751	37	-	65	70	-304.0	-304.0	-304.0
chrX	136230590	136230838	136230567	136230891	JUNC00005753	1	-	23	53	-304.0	-304.0	-304.0
chrX	136230593	136230838	136230520	136230913	JUNC00005752	33	-	73	75	-304.0	-304.0	-304.0
chrX	136230966	136231543	136230892	136231618	JUNC00005754	41	-	74	75	-304.0	-304.0	-304.0
chrX	136232214	136236243	136232158	136236262	JUNC00005756	1	-	56	19	-304.0	-304.0	-304.0
chrX	136232220	136236243	136232146	136236317	JUNC00005755	30	-	74	74	-304.0	-304.0	-304.0
chrX	136236339	136240381	136236267	136240454	JUNC00005757	22	-	72	73	-304.0	-304.0	-304.0
chrX	136240486	136241159	136240426	136241225	JUNC00005758	24	-	60	66	-304.0	-304.0	-304.0
chrX	136241277	136244631	136241202	136244701	JUNC00005759	31	-	75	70	-304.0	-304.0	-304.0
chrX	136244795	136246064	136244721	136246139	JUNC00005760	43	-	74	75	-304.0	-304.0	-304.0
chrX	136246148	136246242	136246075	136246311	JUNC00005761	33	-	73	69	-304.0	-304.0	-304.0
chrX	136246341	136251288	136246272	136251360	JUNC00005762	9	-	69	72	-304.0	-304.0	-304.0
chrX	136497439	136497623	136497414	136497694	JUNC00005763	4	+	25	71	-304.0	-304.0	-304.0
chrX	136497870	136499597	136497795	136499671	JUNC00005764	120	+	75	74	-304.0	-304.0	-304.0
chrX	136499778	136500157	136499703	136500205	JUNC00005765	131	+	75	48	-304.0	-304.0	-304.0
chrX	136500205	136500663	136500155	136500737	JUNC00005766	110	+	50	74	-304.0	-304.0	-304.0
chrX	136500818	136502777	136500743	136502852	JUNC00005767	115	+	75	75	-304.0	-304.0	-304.0
chrX	136502941	136504363	136502869	136504437	JUNC00005768	103	+	72	74	-304.0	-304.0	-304.0
chrX	136502941	136504518	136502916	136504569	JUNC00005769	1	+	25	51	-304.0	-304.0	-304.0
chrX	136504463	136509090	136504390	136509165	JUNC00005770	90	+	73	75	-304.0	-304.0	-304.0
chrX	136509180	136510081	136509106	136510156	JUNC00005771	69	+	74	75	-304.0	-304.0	-304.0
chrX	136510219	136510807	136510145	136510880	JUNC00005772	109	+	74	73	-304.0	-304.0	-304.0
chrX	136668169	136668464	136668094	136668486	JUNC00005774	11	-	75	22	-304.0	-304.0	-304.0
chrX	136668169	136669481	136668094	136669536	JUNC00005773	95	-	75	55	-304.0	-304.0	-304.0
chrX	136669536	136672019	136669465	136672094	JUNC00005775	98	-	71	75	-304.0	-304.0	-304.0
chrX	136672119	136675006	136672046	136675081	JUNC00005776	84	-	73	75	-304.0	-304.0	-304.0
chrX	136675096	136676623	136675021	136676698	JUNC00005777	67	-	75	75	-304.0	-304.0	-304.0
chrX	136676717	136677935	136676645	136677956	JUNC00005778	42	-	72	21	-304.0	-304.0	-304.0
chrX	136677956	136679534	136677934	136679601	JUNC00005779	40	-	22	67	-304.0	-304.0	-304.0
chrX	136679660	136680730	136679585	136680805	JUNC00005780	50	-	75	75	-304.0	-304.0	-304.0
chrX	136679672	136680730	136679649	136680782	JUNC00005781	1	-	23	52	-304.0	-304.0	-304.0
chrX	136680876	136681889	136680801	136681959	JUNC00005782	45	-	75	70	-304.0	-304.0	-304.0
chrX	136681968	136682757	136681893	136682832	JUNC00005783	64	-	75	75	-304.0	-304.0	-304.0
chrX	136682844	136685676	136682774	136685750	JUNC00005784	49	-	70	74	-304.0	-304.0	-304.0
chrX	136685823	136687931	136685749	136687992	JUNC00005785	88	-	74	61	-304.0	-304.0	-304.0
chrX	136687991	136690609	136687930	136690680	JUNC00005786	67	-	61	71	-304.0	-304.0	-304.0
chrX	136690748	136706907	136690673	136706982	JUNC00005787	64	-	75	75	-304.0	-304.0	-304.0
chrX	136707030	136708674	136706957	136708749	JUNC00005788	62	-	73	75	-304.0	-304.0	-304.0
chrX	136708770	136713275	136708696	136713349	JUNC00005789	51	-	74	74	-304.0	-304.0	-304.0
chrX	136713370	136723358	136713321	136723385	JUNC00005791	1	-	49	27	-304.0	-304.0	-304.0
chrX	136713370	136732101	136713296	136732172	JUNC00005790	43	-	74	71	-304.0	-304.0	-304.0
chrX	136732172	136737383	136732119	136737443	JUNC00005793	2	-	53	60	-304.0	-304.0	-304.0
chrX	136732172	136743584	136732100	136743658	JUNC00005792	49	-	72	74	-304.0	-304.0	-304.0
chrX	136743786	136745222	136743718	136745297	JUNC00005794	80	-	68	75	-304.0	-304.0	-304.0
chrX	136745347	136747507	136745273	136747580	JUNC00005795	94	-	74	73	-304.0	-304.0	-304.0
chrX	136747592	136747737	136747566	136747787	JUNC00005798	1	-	26	50	-304.0	-304.0	-304.0
chrX	136747592	136759239	136747568	136759311	JUNC00005799	2	-	24	72	-304.0	-304.0	-304.0
chrX	136747592	136779413	136747517	136779484	JUNC00005796	60	-	75	71	-304.0	-304.0	-304.0
chrX	136747592	136780717	136747558	136780759	JUNC00005797	1	-	34	42	-304.0	-304.0	-304.0
chrX	136779497	136780717	136779422	136780792	JUNC00005800	44	-	75	75	-304.0	-304.0	-304.0
chrX	136837970	136892302	136837953	136892356	JUNC00005801	1	+	17	54	-304.0	-304.0	-304.0
chrX	136848582	136872267	136848519	136872310	JUNC00005802	3	-	63	43	-304.0	-304.0	-304.0
chrX	136870417	136872267	136870342	136872341	JUNC00005803	133	-	75	74	-304.0	-304.0	-304.0
chrX	136870754	136886925	136870725	136886970	JUNC00005804	1	-	29	45	-304.0	-304.0	-304.0
chrX	136872345	136873245	136872270	136873320	JUNC00005806	89	-	75	75	-304.0	-304.0	-304.0
chrX	136872345	136875085	136872270	136875159	JUNC00005805	41	-	75	74	-304.0	-304.0	-304.0
chrX	136874452	136875085	136874377	136875160	JUNC00005807	470	-	75	75	-304.0	-304.0	-304.0
chrX	136875162	136875257	136875087	136875286	JUNC00005808	20	-	75	29	-304.0	-304.0	-304.0
chrX	136875168	136875257	136875093	136875332	JUNC00005809	748	-	75	75	-304.0	-304.0	-304.0
chrX	136875169	136875260	136875148	136875315	JUNC00005810	1	?	21	55	-304.0	-304.0	-304.0
chrX	136875383	136875470	136875308	136875545	JUNC00005811	664	-	75	75	-304.0	-304.0	-304.0
chrX	136875585	136876502	136875510	136876577	JUNC00005812	594	-	75	75	-304.0	-304.0	-304.0
chrX	136876655	136877914	136876581	136877989	JUNC00005813	583	-	74	75	-304.0	-304.0	-304.0
chrX	136876655	136879016	136876598	136879084	JUNC00005814	3	-	57	68	-304.0	-304.0	-304.0
chrX	136878086	136879016	136878011	136879090	JUNC00005815	648	-	75	74	-304.0	-304.0	-304.0
chrX	136879123	136879318	136879048	136879393	JUNC00005816	731	-	75	75	-304.0	-304.0	-304.0
chrX	136879158	136879318	136879121	136879391	JUNC00005817	6	-	37	73	-304.0	-304.0	-304.0
chrX	136879453	136880596	136879378	136880671	JUNC00005818	458	-	75	75	-304.0	-304.0	-304.0
chrX	136909780	136925246	136909762	136925304	JUNC00005819	1	+	18	58	-304.0	-304.0	-304.0
chrX	136925379	136993485	136925352	136993534	JUNC00005820	1	+	27	49	-304.0	-304.0	-304.0
chrX	136994995	137021411	136994967	137021456	JUNC00005821	1	+	28	45	-304.0	-304.0	-304.0
chrX	137354418	137376232	137354369	137376259	JUNC00005822	1	+	49	27	-304.0	-304.0	-304.0
chrX	137651012	137742554	137650982	137742600	JUNC00005823	1	-	30	46	-304.0	-304.0	-304.0
chrX	137710478	137718389	137710445	137718432	JUNC00005824	1	+	33	43	-304.0	-304.0	-304.0
chrX	137774160	137774910	137774143	137774969	JUNC00005825	1	+	17	59	-304.0	-304.0	-304.0
chrX	138282596	138282802	138282537	138282819	JUNC00005827	1	+	59	17	-304.0	-304.0	-304.0
chrX	138282596	138282842	138282537	138282859	JUNC00005826	1	+	59	17	-304.0	-304.0	-304.0
chrX	139582503	139585065	139582428	139585111	JUNC00005828	3	-	75	46	-304.0	-304.0	-304.0
chrX	139585178	139586377	139585120	139586442	JUNC00005829	4	-	58	65	-304.0	-304.0	-304.0
chrX	139586487	139587715	139586441	139587771	JUNC00005830	2	-	46	56	-304.0	-304.0	-304.0
chrX	139588438	139589834	139588371	139589892	JUNC00005831	3	-	67	58	-304.0	-304.0	-304.0
chrX	139596770	139597459	139596722	139597487	JUNC00005832	1	-	48	28	-304.0	-304.0	-304.0
chrX	139597585	139598405	139597531	139598427	JUNC00005833	1	-	54	22	-304.0	-304.0	-304.0
chrX	139602498	139604680	139602451	139604727	JUNC00005834	2	-	47	47	-304.0	-304.0	-304.0
chrX	139616473	139617512	139616431	139617546	JUNC00005835	1	-	42	34	-304.0	-304.0	-304.0
chrX	139617704	139619586	139617648	139619610	JUNC00005837	2	-	56	24	-304.0	-304.0	-304.0
chrX	139617704	139620064	139617648	139620084	JUNC00005836	1	-	56	20	-304.0	-304.0	-304.0
chrX	139629844	139631394	139629815	139631463	JUNC00005838	2	-	29	69	-304.0	-304.0	-304.0
chrX	139646903	139651719	139646856	139651748	JUNC00005839	1	-	47	29	-304.0	-304.0	-304.0
chrX	139710790	139720120	139710755	139720161	JUNC00005840	1	-	35	41	-304.0	-304.0	-304.0
chrX	139728962	139731650	139728892	139731725	JUNC00005841	20	-	70	75	-304.0	-304.0	-304.0
chrX	139728962	139737915	139728899	139737990	JUNC00005842	22	-	63	75	-304.0	-304.0	-304.0
chrX	139731755	139737915	139731680	139737990	JUNC00005843	23	-	75	75	-304.0	-304.0	-304.0
chrX	139738069	139740990	139737995	139741065	JUNC00005844	48	-	74	75	-304.0	-304.0	-304.0
chrX	139741094	139743558	139741024	139743625	JUNC00005845	47	-	70	67	-304.0	-304.0	-304.0
chrX	139741094	139745721	139741071	139745774	JUNC00005846	1	-	23	53	-304.0	-304.0	-304.0
chrX	139743624	139745721	139743558	139745796	JUNC00005847	51	-	66	75	-304.0	-304.0	-304.0
chrX	139745857	139750024	139745782	139750099	JUNC00005848	56	-	75	75	-304.0	-304.0	-304.0
chrX	139750152	139757807	139750077	139757868	JUNC00005849	68	-	75	61	-304.0	-304.0	-304.0
chrX	139757867	139761960	139757807	139762035	JUNC00005850	43	-	60	75	-304.0	-304.0	-304.0
chrX	139762106	139763315	139762032	139763386	JUNC00005851	40	-	74	71	-304.0	-304.0	-304.0
chrX	139763418	139768259	139763344	139768334	JUNC00005852	53	-	74	75	-304.0	-304.0	-304.0
chrX	139768434	139774689	139768362	139774763	JUNC00005853	34	-	72	74	-304.0	-304.0	-304.0
chrX	139774953	139782546	139774878	139782621	JUNC00005854	51	-	75	75	-304.0	-304.0	-304.0
chrX	139782728	139783163	139782654	139783238	JUNC00005855	43	-	74	75	-304.0	-304.0	-304.0
chrX	139783267	139785225	139783196	139785299	JUNC00005856	41	-	71	74	-304.0	-304.0	-304.0
chrX	139785299	139787172	139785225	139787243	JUNC00005857	33	-	74	71	-304.0	-304.0	-304.0
chrX	139787244	139788191	139787174	139788266	JUNC00005858	40	-	70	75	-304.0	-304.0	-304.0
chrX	139788343	139789326	139788270	139789395	JUNC00005859	55	-	73	69	-304.0	-304.0	-304.0
chrX	139789488	139796272	139789419	139796342	JUNC00005860	40	-	69	70	-304.0	-304.0	-304.0
chrX	139796470	139797175	139796401	139797250	JUNC00005861	31	-	69	75	-304.0	-304.0	-304.0
chrX	139797276	139798272	139797255	139798327	JUNC00005863	1	-	21	55	-304.0	-304.0	-304.0
chrX	139797326	139798272	139797255	139798346	JUNC00005862	30	-	71	74	-304.0	-304.0	-304.0
chrX	139798354	139798678	139798280	139798745	JUNC00005864	45	-	74	67	-304.0	-304.0	-304.0
chrX	139798743	139800059	139798678	139800110	JUNC00005865	29	-	65	51	-304.0	-304.0	-304.0
chrX	139800110	139802037	139800070	139802073	JUNC00005867	1	-	40	36	-304.0	-304.0	-304.0
chrX	139800110	139802235	139800057	139802306	JUNC00005866	48	-	53	71	-304.0	-304.0	-304.0
chrX	139802097	139802235	139802082	139802296	JUNC00005868	1	-	15	61	-304.0	-304.0	-304.0
chrX	139802339	139804470	139802264	139804545	JUNC00005869	49	-	75	75	-304.0	-304.0	-304.0
chrX	139804599	139814877	139804529	139814952	JUNC00005870	53	-	70	75	-304.0	-304.0	-304.0
chrX	139814985	139816862	139814910	139816937	JUNC00005871	34	-	75	75	-304.0	-304.0	-304.0
chrX	139816943	139819337	139816875	139819406	JUNC00005872	31	-	68	69	-304.0	-304.0	-304.0
chrX	139819427	139826703	139819361	139826776	JUNC00005873	25	-	66	73	-304.0	-304.0	-304.0
chrX	139826823	139932015	139826750	139932086	JUNC00005874	16	-	73	71	-304.0	-304.0	-304.0
chrX	139826823	139933014	139826808	139933063	JUNC00005875	1	-	15	49	-304.0	-304.0	-304.0
chrX	139876761	139932015	139876714	139932044	JUNC00005876	1	-	47	29	-304.0	-304.0	-304.0
chrX	140558370	140595507	140558333	140595546	JUNC00005877	1	+	37	39	-304.0	-304.0	-304.0
chrX	140706060	140759046	140706041	140759102	JUNC00005878	1	-	19	56	-304.0	-304.0	-304.0
chrX	140707238	140759046	140707219	140759102	JUNC00005879	1	-	19	56	-304.0	-304.0	-304.0
chrX	140735648	140736518	140735591	140736537	JUNC00005880	1	-	57	19	-304.0	126.0	126.0
chrX	141051849	141080492	141051826	141080545	JUNC00005881	1	-	23	53	124.0	-304.0	124.0
chrX	141465321	141484076	141465289	141484120	JUNC00005882	1	-	32	44	-304.0	-304.0	-304.0
chrX	142624662	142738922	142624631	142738967	JUNC00005883	1	+	31	45	-304.0	-304.0	-304.0
chrX	142876142	142903348	142876112	142903394	JUNC00005884	1	-	30	46	-304.0	-304.0	-304.0
chrX	142966224	142977695	142966178	142977725	JUNC00005885	1	-	46	30	-304.0	-304.0	-304.0
chrX	147897131	147902755	147897074	147902773	JUNC00005886	1	-	57	18	-304.0	-304.0	-304.0
chrX	147902787	147904575	147902753	147904614	JUNC00005887	1	-	34	39	-304.0	-304.0	-304.0
chrX	147910995	147911641	147910927	147911649	JUNC00005888	1	-	68	8	-304.0	-304.0	-304.0
chrX	147912230	147912727	147912203	147912799	JUNC00005890	3	+	27	72	-304.0	-304.0	-304.0
chrX	147912230	147921932	147912162	147921985	JUNC00005889	35	+	68	53	-304.0	-304.0	-304.0
chrX	147921985	147925539	147921931	147925609	JUNC00005891	49	+	54	70	-304.0	-304.0	-304.0
chrX	147925633	147928321	147925565	147928393	JUNC00005892	56	+	68	72	-304.0	-304.0	-304.0
chrX	147928393	147928658	147928320	147928733	JUNC00005893	60	+	73	75	-304.0	-304.0	-304.0
chrX	147928807	147929947	147928732	147930021	JUNC00005894	75	+	75	74	-304.0	-304.0	-304.0
chrX	147930041	147930127	147929966	147930201	JUNC00005895	65	+	75	74	-304.0	-304.0	-304.0
chrX	147930244	147932424	147930174	147932498	JUNC00005896	56	+	70	74	-304.0	-304.0	-304.0
chrX	147932595	147932684	147932520	147932756	JUNC00005897	54	+	75	72	-304.0	-304.0	-304.0
chrX	147932763	147933400	147932688	147933454	JUNC00005898	2	+	75	54	-304.0	-304.0	-304.0
chrX	147932763	147936503	147932688	147936574	JUNC00005899	75	+	75	71	-304.0	-304.0	-304.0
chrX	147936613	147937465	147936540	147937540	JUNC00005900	66	+	73	75	-304.0	-304.0	-304.0
chrX	147937600	147938098	147937525	147938162	JUNC00005901	18	+	75	64	-304.0	-304.0	-304.0
chrX	147937600	147940575	147937525	147940650	JUNC00005902	59	+	75	75	-304.0	-304.0	-304.0
chrX	147938161	147940575	147938098	147940650	JUNC00005903	13	+	63	75	-304.0	-304.0	-304.0
chrX	147940662	147943130	147940587	147943203	JUNC00005904	63	+	75	73	-304.0	-304.0	-304.0
chrX	147940662	147944868	147940587	147944871	JUNC00005905	25	+	75	3	-304.0	-304.0	-304.0
chrX	147940662	147944904	147940617	147944935	JUNC00005906	1	+	45	31	-304.0	-304.0	-304.0
chrX	147943326	147944868	147943253	147944942	JUNC00005907	50	+	73	74	-304.0	-304.0	-304.0
chrX	147943326	147944904	147943256	147944977	JUNC00005909	8	+	70	73	-304.0	-304.0	-304.0
chrX	147943326	147944943	147943254	147945016	JUNC00005908	16	+	72	73	-304.0	-304.0	-304.0
chrX	147945051	147945533	147944977	147945608	JUNC00005910	113	+	74	75	-304.0	-304.0	-304.0
chrX	147945616	147948412	147945592	147948470	JUNC00005914	2	+	24	58	-304.0	-304.0	-304.0
chrX	147945616	147948682	147945543	147948757	JUNC00005911	55	+	73	75	-304.0	-304.0	-304.0
chrX	147945616	147948687	147945562	147948760	JUNC00005912	4	+	54	73	-304.0	-304.0	-304.0
chrX	147945616	147948733	147945564	147948807	JUNC00005913	37	+	52	74	-304.0	-304.0	-304.0
chrX	148052320	148052368	148052278	148052402	JUNC00005916	1	?	42	34	-304.0	-304.0	-304.0
chrX	148052324	148052471	148052274	148052496	JUNC00005915	1	?	50	25	-304.0	-304.0	-304.0
chrX	149175476	149253314	149175427	149253341	JUNC00005917	1	-	49	27	-304.0	-304.0	-304.0
chrX	149199664	149217736	149199602	149217793	JUNC00005918	7	+	62	57	-304.0	-304.0	-304.0
chrX	149217813	149219276	149217779	149219318	JUNC00005920	1	+	34	42	-304.0	-304.0	-304.0
chrX	149217813	149222889	149217771	149222923	JUNC00005919	1	+	42	34	-304.0	-304.0	-304.0
chrX	149483218	149486924	149483143	149486999	JUNC00005921	217	-	75	75	-304.0	-304.0	-304.0
chrX	149487098	149490313	149487023	149490388	JUNC00005922	254	-	75	75	-304.0	-304.0	-304.0
chrX	149487313	149490313	149487258	149490388	JUNC00005923	39	-	55	75	-304.0	-304.0	-304.0
chrX	149490440	149491537	149490365	149491610	JUNC00005924	30	-	75	73	-304.0	-304.0	-304.0
chrX	149490440	149496345	149490365	149496418	JUNC00005925	239	-	75	73	-304.0	-304.0	-304.0
chrX	149491667	149496345	149491603	149496396	JUNC00005926	18	-	64	51	-304.0	-304.0	-304.0
chrX	149495688	149496345	149495663	149496418	JUNC00005927	3	-	25	73	-304.0	-304.0	-304.0
chrX	149496507	149498106	149496432	149498154	JUNC00005928	5	-	75	48	-304.0	-304.0	-304.0
chrX	149496516	149498106	149496441	149498181	JUNC00005929	232	-	75	75	-304.0	-304.0	-304.0
chrX	149498307	149499228	149498254	149499286	JUNC00005931	2	-	53	58	-304.0	-304.0	-304.0
chrX	149498307	149500948	149498234	149501022	JUNC00005930	264	-	73	74	-304.0	-304.0	-304.0
chrX	149501037	149502074	149500962	149502146	JUNC00005933	30	-	75	72	-304.0	-304.0	-304.0
chrX	149501037	149503311	149500962	149503386	JUNC00005932	209	-	75	75	-304.0	-304.0	-304.0
chrX	149502119	149503311	149502074	149503331	JUNC00005934	1	-	45	20	-304.0	-304.0	-304.0
chrX	149502177	149503311	149502117	149503385	JUNC00005935	7	-	60	74	-304.0	-304.0	-304.0
chrX	149502223	149503311	149502182	149503386	JUNC00005937	3	-	41	75	-304.0	-304.0	-304.0
chrX	149502223	149503337	149502164	149503412	JUNC00005936	3	-	59	75	-304.0	-304.0	-304.0
chrX	149503445	149504152	149503429	149504212	JUNC00005940	1	-	16	60	-304.0	-304.0	-304.0
chrX	149503445	149504156	149503370	149504222	JUNC00005938	11	-	75	66	-304.0	-304.0	-304.0
chrX	149503489	149504156	149503415	149504231	JUNC00005939	221	-	74	75	-304.0	-304.0	-304.0
chrX	149504293	149504397	149504262	149504442	JUNC00005942	1	-	31	45	-304.0	-304.0	-304.0
chrX	149504293	149505034	149504218	149505107	JUNC00005941	180	-	75	73	-304.0	-304.0	-304.0
chrX	149511620	149525721	149511584	149525761	JUNC00005943	1	-	36	40	-304.0	-304.0	-304.0
chrX	149525076	149525743	149525027	149525817	JUNC00005944	53	+	49	74	-304.0	-304.0	-304.0
chrX	149525076	149525787	149525034	149525855	JUNC00005945	6	+	42	68	-304.0	-304.0	-304.0
chrX	149526794	149526935	149526749	149526966	JUNC00005946	1	-	45	31	-304.0	-304.0	-304.0
chrX	149528358	149529366	149528344	149529428	JUNC00005947	1	-	14	62	-304.0	-304.0	-304.0
chrX	149529428	149529512	149529403	149529575	JUNC00005948	3	-	25	63	-304.0	-304.0	-304.0
chrX	149529593	149532881	149529550	149532942	JUNC00005949	4	-	43	61	-304.0	-304.0	-304.0
chrX	149533714	149534203	149533667	149534232	JUNC00005950	1	-	47	29	-304.0	-304.0	-304.0
chrX	149533987	149534203	149533926	149534224	JUNC00005951	2	-	61	21	-304.0	-304.0	-304.0
chrX	149534374	149538114	149534324	149538140	JUNC00005952	1	-	50	26	-304.0	-304.0	-304.0
chrX	149534888	149535699	149534845	149535732	JUNC00005953	1	-	43	33	-304.0	-304.0	-304.0
chrX	149536255	149537632	149536237	149537690	JUNC00005954	1	-	18	58	-304.0	-304.0	-304.0
chrX	149537778	149538114	149537705	149538160	JUNC00005955	2	-	73	46	-304.0	-304.0	-304.0
chrX	149538172	149538723	149538114	149538794	JUNC00005956	3	-	58	71	-304.0	-304.0	-304.0
chrX	149538906	149540694	149538865	149540729	JUNC00005957	1	-	41	35	-304.0	-304.0	-304.0
chrX	149540799	149542018	149540749	149542066	JUNC00005958	4	+	50	48	-304.0	-304.0	-304.0
chrX	149541292	149542018	149541235	149542066	JUNC00005960	4	+	57	48	-304.0	-304.0	-304.0
chrX	149541343	149542018	149541269	149542075	JUNC00005961	38	+	74	57	-304.0	-304.0	-304.0
chrX	149542066	149545367	149542015	149545442	JUNC00005959	71	+	51	75	-304.0	-304.0	-304.0
chrX	149542085	149545367	149542017	149545442	JUNC00005962	26	+	68	75	-304.0	-304.0	-304.0
chrX	149545500	149545601	149545425	149545673	JUNC00005963	84	+	75	72	-304.0	-304.0	-304.0
chrX	149545883	149546738	149545808	149546813	JUNC00005964	179	+	75	75	-304.0	-304.0	-304.0
chrX	149546917	149549415	149546844	149549469	JUNC00005965	5	+	73	54	-304.0	-304.0	-304.0
chrX	149548910	149549369	149548870	149549405	JUNC00005966	1	-	40	36	-304.0	-304.0	-304.0
chrX	149597899	149771410	149597872	149771459	JUNC00005967	1	-	27	49	-304.0	-304.0	-304.0
chrX	149597968	149771479	149597919	149771506	JUNC00005968	1	+	49	27	-304.0	-304.0	-304.0
chrX	149598255	149599553	149598181	149599625	JUNC00005969	17	-	74	72	-304.0	-304.0	-304.0
chrX	149599677	149600302	149599602	149600373	JUNC00005970	45	-	75	71	-304.0	-304.0	-304.0
chrX	149600479	149603375	149600453	149603425	JUNC00005973	1	-	26	50	-304.0	-304.0	-304.0
chrX	149600479	149603986	149600406	149604057	JUNC00005971	34	-	73	71	-304.0	-304.0	-304.0
chrX	149600479	149631542	149600420	149631601	JUNC00005972	4	-	59	59	-304.0	-304.0	-304.0
chrX	149604070	149605103	149604049	149605158	JUNC00005976	1	-	21	55	-304.0	-304.0	-304.0
chrX	149604070	149606837	149604039	149606882	JUNC00005975	1	-	31	45	-304.0	-304.0	-304.0
chrX	149604070	149608626	149604000	149608696	JUNC00005974	18	-	70	70	-304.0	-304.0	-304.0
chrX	149604070	149631542	149604052	149631600	JUNC00005977	1	-	18	58	-304.0	-304.0	-304.0
chrX	149606809	149608626	149606786	149608679	JUNC00005978	1	-	23	53	-304.0	-304.0	-304.0
chrX	149608829	149611286	149608773	149611306	JUNC00005980	1	-	56	20	-304.0	-304.0	-304.0
chrX	149608834	149611286	149608761	149611360	JUNC00005979	50	-	73	74	-304.0	-304.0	-304.0
chrX	149611463	149631542	149611388	149631614	JUNC00005981	38	-	75	72	-304.0	-304.0	-304.0
chrX	149714576	149715603	149714525	149715628	JUNC00005982	1	+	51	25	-304.0	-304.0	-304.0
chrX	149930081	149932588	149930021	149932661	JUNC00005983	18	-	60	73	-304.0	-304.0	-304.0
chrX	149930127	149930586	149930091	149930626	JUNC00005984	1	+	36	40	-304.0	-304.0	-304.0
chrX	149932345	149932433	149932306	149932470	JUNC00005985	1	?	39	37	-304.0	-304.0	-304.0
chrX	149932767	149933621	149932692	149933696	JUNC00005986	203	-	75	75	-304.0	-304.0	-304.0
chrX	149933737	149934004	149933662	149934025	JUNC00005987	3	-	75	21	-304.0	-304.0	-304.0
chrX	149933903	149934004	149933828	149934079	JUNC00005988	111	-	75	75	-304.0	-304.0	-304.0
chrX	149934137	149935149	149934108	149935196	JUNC00005991	1	-	29	47	-304.0	-304.0	-304.0
chrX	149934137	149937413	149934064	149937462	JUNC00005990	13	-	73	49	-304.0	-304.0	-304.0
chrX	149934137	149937432	149934062	149937481	JUNC00005989	61	-	75	49	-304.0	-304.0	-304.0
chrX	149934573	149937432	149934526	149937461	JUNC00005995	1	-	47	29	-304.0	-304.0	-304.0
chrX	149937480	149937623	149937456	149937698	JUNC00005996	2	-	24	75	-304.0	-304.0	-304.0
chrX	149937480	149938141	149937432	149938215	JUNC00005992	10	-	48	74	-304.0	-304.0	-304.0
chrX	149937480	149938192	149937413	149938267	JUNC00005993	38	-	67	75	-304.0	-304.0	-304.0
chrX	149937480	149938395	149937432	149938449	JUNC00005994	2	-	48	54	-304.0	-304.0	-304.0
chrX	149937745	149938192	149937714	149938237	JUNC00005997	1	-	31	45	-304.0	-304.0	-304.0
chrX	149940886	149941789	149940820	149941790	JUNC00005998	1	+	66	1	-304.0	-304.0	-304.0
chrX	149943762	149944017	149943726	149944057	JUNC00005999	1	+	36	40	-304.0	-304.0	-304.0
chrX	149946028	149946514	149945999	149946561	JUNC00006000	1	+	29	47	-304.0	-304.0	-304.0
chrX	149948394	149960764	149948321	149960818	JUNC00006001	5	+	73	54	-304.0	-304.0	-304.0
chrX	150016500	150016610	150016434	150016663	JUNC00006002	2	+	66	53	-304.0	-304.0	-304.0
chrX	150568718	150592604	150568696	150592658	JUNC00006003	1	+	22	54	-304.0	-304.0	-304.0
chrX	150592677	150596497	150592632	150596565	JUNC00006004	5	+	45	68	-304.0	-304.0	-304.0
chrX	150596570	150598591	150596501	150598664	JUNC00006005	11	+	69	73	-304.0	-304.0	-304.0
chrX	150598686	150614588	150598628	150614649	JUNC00006006	7	+	58	61	-304.0	-304.0	-304.0
chrX	150614699	150619037	150614626	150619109	JUNC00006007	12	+	73	72	-304.0	-304.0	-304.0
chrX	150619139	150638942	150619076	150639008	JUNC00006008	14	+	63	66	-304.0	-304.0	-304.0
chrX	150639026	150641268	150638952	150641338	JUNC00006009	12	+	74	70	-304.0	-304.0	-304.0
chrX	150641418	150645682	150641343	150645757	JUNC00006010	13	+	75	75	-304.0	-304.0	-304.0
chrX	150645871	150649715	150645804	150649785	JUNC00006011	17	+	67	70	-304.0	-304.0	-304.0
chrX	150658027	150659663	150657975	150659738	JUNC00006012	12	+	52	75	-304.0	-304.0	-304.0
chrX	150659756	150660370	150659684	150660438	JUNC00006013	9	+	72	68	-304.0	-304.0	-304.0
chrX	150660484	150663432	150660423	150663507	JUNC00006014	6	+	61	75	-304.0	-304.0	-304.0
chrX	150663609	150671427	150663544	150671500	JUNC00006015	23	+	65	73	-304.0	-304.0	-304.0
chrX	150663609	150671430	150663559	150671456	JUNC00006016	1	+	50	26	-304.0	-304.0	-304.0
chrX	150667281	150671430	150667225	150671505	JUNC00006017	3	+	56	75	-304.0	-304.0	-304.0
chrX	150693676	150699194	150693633	150699268	JUNC00006018	12	+	43	74	-304.0	-304.0	-304.0
chrX	150699300	150712341	150699225	150712365	JUNC00006020	53	+	75	24	-304.0	-304.0	-304.0
chrX	150699300	150718624	150699225	150718697	JUNC00006019	4	+	75	73	-304.0	-304.0	-304.0
chrX	150699300	150727214	150699274	150727289	JUNC00006022	3	+	26	75	-304.0	-304.0	-304.0
chrX	150712365	150718624	150712340	150718698	JUNC00006021	69	+	25	74	-304.0	-304.0	-304.0
chrX	150718700	150726409	150718649	150726468	JUNC00006024	3	+	51	59	-304.0	-304.0	-304.0
chrX	150718700	150727214	150718629	150727289	JUNC00006023	73	+	71	75	-304.0	-304.0	-304.0
chrX	150727309	150727683	150727234	150727757	JUNC00006025	90	+	75	74	-304.0	-304.0	-304.0
chrX	150727791	150730108	150727716	150730180	JUNC00006026	87	+	75	72	-304.0	-304.0	-304.0
chrX	150730210	150730524	150730135	150730599	JUNC00006027	53	+	75	75	-304.0	-304.0	-304.0
chrX	150730608	150731469	150730533	150731544	JUNC00006028	58	+	75	75	-304.0	-304.0	-304.0
chrX	150731619	150732541	150731546	150732616	JUNC00006029	61	+	73	75	-304.0	-304.0	-304.0
chrX	150732730	150736594	150732656	150736669	JUNC00006030	111	+	74	75	-304.0	-304.0	-304.0
chrX	150732730	150737241	150732685	150737288	JUNC00006031	2	+	45	47	-304.0	-304.0	-304.0
chrX	150736780	150737241	150736705	150737315	JUNC00006032	72	+	75	74	-304.0	-304.0	-304.0
chrX	150737448	150744360	150737374	150744433	JUNC00006033	86	+	74	73	-304.0	-304.0	-304.0
chrX	150744453	150750729	150744378	150750804	JUNC00006034	78	+	75	75	-304.0	-304.0	-304.0
chrX	150750843	150751029	150750771	150751077	JUNC00006036	4	+	72	48	-304.0	-304.0	-304.0
chrX	150750843	150752825	150750807	150752865	JUNC00006037	1	+	36	40	-304.0	-304.0	-304.0
chrX	150750843	150755688	150750770	150755758	JUNC00006035	46	+	73	70	-304.0	-304.0	-304.0
chrX	150750843	150762564	150750808	150762605	JUNC00006038	1	+	35	41	-304.0	-304.0	-304.0
chrX	150751240	150755688	150751207	150755731	JUNC00006039	1	+	33	43	-304.0	-304.0	-304.0
chrX	150755865	150762564	150755790	150762637	JUNC00006040	29	+	75	73	-304.0	-304.0	-304.0
chrX	150769101	150770303	150769026	150770369	JUNC00006041	36	-	75	66	-304.0	-304.0	-304.0
chrX	150770369	150776173	150770303	150776241	JUNC00006042	32	-	66	68	-304.0	-304.0	-304.0
chrX	150776293	150777443	150776220	150777482	JUNC00006043	41	-	73	39	-304.0	-304.0	-304.0
chrX	150777482	150785105	150777443	150785138	JUNC00006045	1	-	39	33	-304.0	-304.0	-304.0
chrX	150777482	150793690	150777426	150793757	JUNC00006044	57	-	56	67	-304.0	-304.0	-304.0
chrX	150788071	150793690	150788016	150793711	JUNC00006047	1	-	55	21	-304.0	-304.0	-304.0
chrX	150793756	150795205	150793690	150795280	JUNC00006046	91	-	66	75	-304.0	-304.0	-304.0
chrX	150795289	150795417	150795214	150795487	JUNC00006048	112	-	75	70	-304.0	-304.0	-304.0
chrX	150795486	150814861	150795416	150814935	JUNC00006049	119	-	70	74	-304.0	-304.0	-304.0
chrX	150795486	150831230	150795430	150831293	JUNC00006050	3	-	56	63	-304.0	-304.0	-304.0
chrX	150800814	150860923	150800784	150860969	JUNC00006052	1	-	30	46	-304.0	-304.0	-304.0
chrX	150810983	150867675	150810942	150867710	JUNC00006053	1	-	41	35	-304.0	-304.0	-304.0
chrX	150814936	150816006	150814861	150816078	JUNC00006054	133	-	75	72	-304.0	-304.0	-304.0
chrX	150816078	150816278	150816029	150816332	JUNC00006057	2	-	49	54	-304.0	-304.0	-304.0
chrX	150816078	150828305	150816020	150828341	JUNC00006056	3	-	58	36	-304.0	-304.0	-304.0
chrX	150816078	150831230	150816005	150831294	JUNC00006055	74	-	73	64	-304.0	-304.0	-304.0
chrX	150816455	150828305	150816417	150828361	JUNC00006059	2	-	38	56	-304.0	-304.0	-304.0
chrX	150828368	150831230	150828337	150831288	JUNC00006060	2	-	31	58	-304.0	-304.0	-304.0
chrX	150831293	150879514	150831230	150879584	JUNC00006058	10	-	63	70	-304.0	-304.0	-304.0
chrX	150831293	150898521	150831230	150898593	JUNC00006051	40	-	63	72	-304.0	-304.0	-304.0
chrX	150896272	150970479	150896248	150970534	JUNC00006061	10	-	24	55	-304.0	-304.0	-304.0
chrX	150962311	150969759	150962294	150969823	JUNC00006062	2	+	17	64	108.0	-304.0	108.0
chrX	150983376	150985594	150983306	150985669	JUNC00006063	57	+	70	75	-304.0	-304.0	-304.0
chrX	150983591	150985594	150983518	150985669	JUNC00006064	26	+	73	75	-304.0	-304.0	-304.0
chrX	150983593	150985594	150983575	150985652	JUNC00006065	1	+	18	58	-304.0	-304.0	-304.0
chrX	150985749	150986050	150985675	150986125	JUNC00006066	285	+	74	75	-304.0	-304.0	-304.0
chrX	150986190	150987127	150986115	150987202	JUNC00006067	262	+	75	75	-304.0	-304.0	-304.0
chrX	150987219	150987776	150987147	150987851	JUNC00006068	6	+	72	75	-304.0	-304.0	-304.0
chrX	150987302	150987776	150987227	150987851	JUNC00006069	262	+	75	75	-304.0	-304.0	-304.0
chrX	151396647	151403630	151396591	151403650	JUNC00006070	1	+	56	20	-304.0	-304.0	-304.0
chrX	151397057	151403630	151397041	151403690	JUNC00006071	1	+	16	60	-304.0	-304.0	-304.0
chrX	151397361	151403630	151397291	151403704	JUNC00006072	53	+	70	74	-304.0	-304.0	-304.0
chrX	151403740	151404915	151403666	151404990	JUNC00006073	82	+	74	75	-304.0	-304.0	-304.0
chrX	152649333	152649741	152649310	152649794	JUNC00006074	1	+	23	53	-304.0	-304.0	-304.0
chrX	152650580	152651525	152650533	152651554	JUNC00006075	1	+	47	29	-304.0	-304.0	-304.0
chrX	152827930	152828536	152827855	152828611	JUNC00006076	102	-	75	75	-304.0	-304.0	-304.0
chrX	152828674	152829148	152828599	152829219	JUNC00006077	66	-	75	71	-304.0	-304.0	-304.0
chrX	152829277	152829601	152829205	152829674	JUNC00006078	66	-	72	73	-304.0	-304.0	-304.0
chrX	152829760	152830707	152829686	152830738	JUNC00006079	23	-	74	31	-304.0	-304.0	-304.0
chrX	152831117	152831633	152831042	152831700	JUNC00006080	15	+	75	67	-304.0	-304.0	-304.0
chrX	152831117	152831638	152831045	152831655	JUNC00006082	7	+	72	17	-304.0	-304.0	-304.0
chrX	152831117	152846281	152831042	152846355	JUNC00006081	95	+	75	74	-304.0	-304.0	-304.0
chrX	152831700	152832970	152831659	152833005	JUNC00006084	1	+	41	35	-304.0	-304.0	-304.0
chrX	152831700	152846281	152831633	152846340	JUNC00006083	13	+	67	59	-304.0	-304.0	-304.0
chrX	152833064	152846281	152833035	152846328	JUNC00006085	1	+	29	47	-304.0	-304.0	-304.0
chrX	152846432	152850264	152846357	152850338	JUNC00006086	171	+	75	74	-304.0	-304.0	-304.0
chrX	152850423	152858769	152850348	152858844	JUNC00006087	131	+	75	75	-304.0	-304.0	-304.0
chrX	152850423	152862595	152850402	152862670	JUNC00006088	22	+	21	75	-304.0	-304.0	-304.0
chrX	152858916	152862595	152858841	152862670	JUNC00006089	154	+	75	75	-304.0	-304.0	-304.0
chrX	152862724	152865818	152862650	152865893	JUNC00006090	147	+	74	75	-304.0	-304.0	-304.0
chrX	152865961	152867570	152865888	152867645	JUNC00006091	151	+	73	75	-304.0	-304.0	-304.0
chrX	152867673	152868783	152867604	152868858	JUNC00006092	123	+	69	75	-304.0	-304.0	-304.0
chrX	152918154	152918982	152918080	152919039	JUNC00006093	10	+	74	57	-304.0	-304.0	-304.0
chrX	152919081	152920327	152919022	152920392	JUNC00006095	3	+	59	65	-304.0	-304.0	-304.0
chrX	152919081	152920706	152919021	152920722	JUNC00006094	1	+	60	16	-304.0	-304.0	-304.0
chrX	152920411	152920706	152920351	152920748	JUNC00006097	5	+	60	42	-304.0	-304.0	-304.0
chrX	152920411	152920709	152920341	152920737	JUNC00006096	3	+	70	28	-304.0	-304.0	-304.0
chrX	152920748	152922172	152920705	152922225	JUNC00006098	10	+	43	53	-304.0	-304.0	-304.0
chrX	152922256	152922719	152922184	152922767	JUNC00006099	4	+	72	48	-304.0	-304.0	-304.0
chrX	152922256	152928574	152922194	152928613	JUNC00006101	3	+	62	39	-304.0	-304.0	-304.0
chrX	152922256	152931671	152922185	152931721	JUNC00006100	7	+	71	50	-304.0	-304.0	-304.0
chrX	152922809	152928574	152922750	152928619	JUNC00006102	3	+	59	45	-304.0	-304.0	-304.0
chrX	152928661	152931671	152928610	152931698	JUNC00006103	2	+	51	27	-304.0	-304.0	-304.0
chrX	152931776	152932872	152931712	152932942	JUNC00006104	10	+	64	70	-304.0	-304.0	-304.0
chrX	152931776	152938073	152931743	152938116	JUNC00006105	1	+	33	43	-304.0	-304.0	-304.0
chrX	152932971	152938073	152932901	152938128	JUNC00006106	13	+	70	55	-304.0	-304.0	-304.0
chrX	152938163	152945266	152938089	152945313	JUNC00006107	5	+	74	47	-304.0	-304.0	-304.0
chrX	152941830	152945266	152941800	152945312	JUNC00006108	1	+	30	46	-304.0	-304.0	-304.0
chrX	152941835	152945266	152941802	152945309	JUNC00006109	1	+	33	43	-304.0	-304.0	-304.0
chrX	152945464	152959698	152945405	152959765	JUNC00006110	6	+	59	67	-304.0	-304.0	-304.0
chrX	152959896	152963838	152959829	152963902	JUNC00006111	10	+	67	64	-304.0	-304.0	-304.0
chrX	152963949	152965446	152963882	152965518	JUNC00006112	14	+	67	72	-304.0	-304.0	-304.0
chrX	152965527	152967166	152965452	152967238	JUNC00006113	11	+	75	72	-304.0	-304.0	-304.0
chrX	152967238	152969381	152967171	152969436	JUNC00006114	6	+	67	55	-304.0	-304.0	-304.0
chrX	152969484	152970442	152969413	152970516	JUNC00006115	15	+	71	74	-304.0	-304.0	-304.0
chrX	152970541	152971273	152970486	152971338	JUNC00006116	6	+	55	65	-304.0	-304.0	-304.0
chrX	153231398	153248332	153231383	153248391	JUNC00006117	1	-	15	59	-304.0	-304.0	-304.0
chrX	153336710	153345519	153336659	153345593	JUNC00006118	11	+	51	74	-304.0	-304.0	-304.0
chrX	153345621	153346818	153345549	153346893	JUNC00006119	24	+	72	75	-304.0	-304.0	-304.0
chrX	153418355	153418672	153418329	153418722	JUNC00006120	1	+	26	50	-304.0	-304.0	-304.0
chrX	153418799	153419902	153418741	153419920	JUNC00006122	1	+	58	18	-304.0	-304.0	-304.0
chrX	153418799	153420227	153418726	153420299	JUNC00006121	7	+	73	72	-304.0	-304.0	-304.0
chrX	153447909	153454393	153447836	153454468	JUNC00006123	61	-	73	75	-304.0	-304.0	-304.0
chrX	153454508	153454876	153454433	153454944	JUNC00006125	12	-	75	68	-304.0	-304.0	-304.0
chrX	153454508	153455541	153454433	153455615	JUNC00006124	50	-	75	74	-304.0	-304.0	-304.0
chrX	153455053	153455541	153454982	153455607	JUNC00006126	9	-	71	66	-304.0	-304.0	-304.0
chrX	153455648	153456264	153455647	153456339	JUNC00006127	11	-	1	75	-304.0	-304.0	-304.0
chrX	153455766	153456264	153455695	153456295	JUNC00006128	4	-	71	31	-304.0	-304.0	-304.0
chrX	153456364	153456492	153456289	153456567	JUNC00006129	68	-	75	75	-304.0	-304.0	-304.0
chrX	153456651	153457136	153456576	153457209	JUNC00006130	101	-	75	73	-304.0	-304.0	-304.0
chrX	153457228	153460972	153457155	153461023	JUNC00006132	4	-	73	51	-304.0	-304.0	-304.0
chrX	153457228	153462001	153457155	153462005	JUNC00006131	35	-	73	4	-304.0	-304.0	-304.0
chrX	153457228	153462609	153457155	153462672	JUNC00006133	100	-	73	63	-304.0	-304.0	-304.0
chrX	153462671	153464987	153462599	153465056	JUNC00006135	111	-	72	69	-304.0	-304.0	-304.0
chrX	153462671	153469145	153462609	153469146	JUNC00006134	7	-	62	1	-304.0	-304.0	-304.0
chrX	153465055	153469145	153464987	153469220	JUNC00006136	94	-	68	75	-304.0	-304.0	-304.0
chrX	153469261	153469744	153469187	153469801	JUNC00006138	3	-	74	57	-304.0	-304.0	-304.0
chrX	153469261	153470449	153469187	153470524	JUNC00006137	79	-	74	75	-304.0	-304.0	-304.0
chrX	153588394	153592505	153588323	153592571	JUNC00006139	15	-	71	66	-304.0	-304.0	-304.0
chrX	153588454	153592505	153588379	153592577	JUNC00006140	20	-	75	72	-304.0	-304.0	-304.0
chrX	153592703	153594546	153592648	153594566	JUNC00006141	1	-	55	20	-304.0	-304.0	-304.0
chrX	153592733	153594546	153592660	153594621	JUNC00006142	36	-	73	75	-304.0	-304.0	-304.0
chrX	153594679	153596003	153594605	153596078	JUNC00006143	65	-	74	75	-304.0	-304.0	-304.0
chrX	153596187	153598961	153596114	153599027	JUNC00006144	34	-	73	66	-304.0	-304.0	-304.0
chrX	153656121	153660670	153656082	153660707	JUNC00006145	1	+	39	37	-304.0	-304.0	-304.0
chrX	153670130	153670449	153670087	153670484	JUNC00006146	2	-	43	35	-304.0	-304.0	-304.0
chrX	153670594	153670743	153670578	153670815	JUNC00006147	2	-	16	72	-304.0	-304.0	-304.0
chrX	153671190	153671284	153671140	153671323	JUNC00006148	3	-	50	39	-304.0	-304.0	-304.0
chrX	153671360	153671548	153671313	153671600	JUNC00006149	4	-	47	52	-304.0	-304.0	-304.0
chrX	153671672	153671879	153671611	153671945	JUNC00006150	8	-	61	66	-304.0	-304.0	-304.0
chrX	153672018	153672125	153671944	153672178	JUNC00006151	6	-	74	53	-304.0	-304.0	-304.0
chrX	153672200	153672565	153672142	153672628	JUNC00006152	4	-	58	63	-304.0	-304.0	-304.0
chrX	153672697	153673008	153672660	153673068	JUNC00006153	3	-	37	60	-304.0	-304.0	-304.0
chrX	153673078	153673779	153673022	153673819	JUNC00006154	3	-	56	40	-304.0	-304.0	-304.0
chrX	153688836	153690374	153688800	153690416	JUNC00006155	2	+	36	42	-304.0	-304.0	-304.0
chrX	153690506	153691303	153690431	153691370	JUNC00006156	7	+	75	67	-304.0	-304.0	-304.0
chrX	153691553	153691974	153691485	153692043	JUNC00006157	10	+	68	69	-304.0	-304.0	-304.0
chrX	153692107	153693040	153692032	153693115	JUNC00006158	19	+	75	75	-304.0	-304.0	-304.0
chrX	153693175	153693262	153693118	153693304	JUNC00006159	6	+	57	42	-304.0	-304.0	-304.0
chrX	153693366	153693461	153693308	153693536	JUNC00006160	13	+	58	75	-304.0	-304.0	-304.0
chrX	153693586	153693904	153693511	153693968	JUNC00006161	8	+	75	64	-304.0	-304.0	-304.0
chrX	153694017	153694129	153693963	153694170	JUNC00006162	2	+	54	41	-304.0	-304.0	-304.0
chrX	153694267	153694343	153694210	153694416	JUNC00006163	8	+	57	73	-304.0	-304.0	-304.0
chrX	153694446	153694532	153694376	153694606	JUNC00006164	12	+	70	74	-304.0	-304.0	-304.0
chrX	153694633	153694718	153694576	153694792	JUNC00006165	13	+	57	74	-304.0	-304.0	-304.0
chrX	153694889	153695073	153694844	153695104	JUNC00006166	1	+	45	31	-304.0	-304.0	-304.0
chrX	153700975	153702006	153700900	153702081	JUNC00006167	356	-	75	75	-304.0	-304.0	-304.0
chrX	153702107	153702934	153702032	153703009	JUNC00006168	506	-	75	75	-304.0	-304.0	-304.0
chrX	153703058	153703958	153702983	153704033	JUNC00006169	597	-	75	75	-304.0	-304.0	-304.0
chrX	153704094	153715541	153704019	153715616	JUNC00006170	505	-	75	75	-304.0	-304.0	-304.0
chrX	153715689	153720871	153715614	153720946	JUNC00006171	546	-	75	75	-304.0	-304.0	-304.0
chrX	153720972	153723152	153720897	153723227	JUNC00006172	374	-	75	75	-304.0	-304.0	-304.0
chrX	153723288	153723507	153723213	153723578	JUNC00006173	33	-	75	71	-304.0	-304.0	-304.0
chrX	153723288	153723827	153723213	153723881	JUNC00006175	3	-	75	54	-304.0	-304.0	-304.0
chrX	153723288	153724200	153723222	153724220	JUNC00006176	2	-	66	20	-304.0	-304.0	-304.0
chrX	153723288	153724333	153723213	153724399	JUNC00006174	133	-	75	66	-304.0	-304.0	-304.0
chrX	153726166	153729231	153726095	153729303	JUNC00006177	12	+	71	72	-304.0	-304.0	-304.0
chrX	153729412	153736111	153729342	153736185	JUNC00006178	11	+	70	74	-304.0	-304.0	-304.0
chrX	153736254	153736344	153736181	153736419	JUNC00006179	23	+	73	75	-304.0	-304.0	-304.0
chrX	153736513	153736611	153736496	153736668	JUNC00006181	1	+	17	57	-304.0	-304.0	-304.0
chrX	153736513	153737156	153736440	153737224	JUNC00006180	16	+	73	68	-304.0	-304.0	-304.0
chrX	153737251	153740091	153737176	153740154	JUNC00006182	12	+	75	63	-304.0	-304.0	-304.0
chrX	153740237	153740573	153740177	153740646	JUNC00006183	17	+	60	73	-304.0	-304.0	-304.0
chrX	153740719	153742986	153740644	153743039	JUNC00006184	12	+	75	53	-304.0	-304.0	-304.0
chrX	153743071	153743220	153743006	153743291	JUNC00006185	16	+	65	71	-304.0	-304.0	-304.0
chrX	153743346	153743488	153743277	153743562	JUNC00006186	23	+	69	74	-304.0	-304.0	-304.0
chrX	153748744	153809341	153748712	153809385	JUNC00006187	1	-	32	44	-304.0	-304.0	-304.0
chrX	153768428	153768947	153768409	153769004	JUNC00006188	1	+	19	57	-304.0	-304.0	-304.0
chrX	153772015	153772181	153771995	153772237	JUNC00006189	1	+	20	56	-304.0	-304.0	-304.0
chrX	153773016	153773229	153772959	153773248	JUNC00006190	1	+	57	19	-304.0	-304.0	-304.0
chrX	153773713	153773858	153773654	153773908	JUNC00006191	2	+	59	50	-304.0	-304.0	-304.0
chrX	153776214	153776355	153776193	153776410	JUNC00006192	1	+	21	55	-304.0	-304.0	-304.0
chrX	153777688	153777947	153777649	153777984	JUNC00006193	1	+	39	37	-304.0	-304.0	-304.0
chrX	153785973	153786211	153785901	153786272	JUNC00006194	216	-	72	61	-304.0	-304.0	-304.0
chrX	153786272	153786354	153786202	153786429	JUNC00006195	281	-	70	75	-304.0	-304.0	-304.0
chrX	153786449	153786800	153786375	153786875	JUNC00006196	207	-	74	75	-304.0	-304.0	-304.0
chrX	153786449	153787050	153786396	153787114	JUNC00006197	11	-	53	64	-304.0	-304.0	-304.0
chrX	153786947	153787050	153786872	153787123	JUNC00006198	217	-	75	73	-304.0	-304.0	-304.0
chrX	153786970	153787050	153786950	153787120	JUNC00006199	3	-	20	70	-304.0	-304.0	-304.0
chrX	153787153	153787463	153787078	153787538	JUNC00006200	367	-	75	75	-304.0	-304.0	-304.0
chrX	153787597	153787822	153787524	153787897	JUNC00006201	330	-	73	75	-304.0	-304.0	-304.0
chrX	153787955	153788074	153787880	153788136	JUNC00006202	478	-	75	62	-304.0	-304.0	-304.0
chrX	153788135	153789711	153788063	153789785	JUNC00006203	355	-	72	74	-304.0	-304.0	-304.0
chrX	153789824	153790194	153789749	153790268	JUNC00006204	197	-	75	74	-304.0	-304.0	-304.0
chrX	153790292	153790563	153790254	153790575	JUNC00006206	21	-	38	12	-304.0	-304.0	-304.0
chrX	153790292	153790809	153790243	153790836	JUNC00006205	1	-	49	27	-304.0	-304.0	-304.0
chrX	153790575	153790809	153790516	153790879	JUNC00006207	54	-	59	70	-304.0	-304.0	-304.0
chrX	153790851	153794245	153790782	153794318	JUNC00006208	77	-	69	73	-304.0	-304.0	-304.0
chrX	153790851	153794314	153790809	153794361	JUNC00006209	4	-	42	47	-304.0	-304.0	-304.0
chrX	153791308	153792246	153791260	153792278	JUNC00006210	2	-	48	32	-304.0	-304.0	-304.0
chrX	153794585	153794673	153794584	153794748	JUNC00006211	1	+	1	75	-304.0	-304.0	-304.0
chrX	153794754	153795662	153794684	153795733	JUNC00006213	22	+	70	71	-304.0	-304.0	-304.0
chrX	153794754	153796433	153794679	153796508	JUNC00006212	628	+	75	75	-304.0	-304.0	-304.0
chrX	153795741	153795821	153795693	153795849	JUNC00006214	1	?	48	28	-304.0	-304.0	-304.0
chrX	153795753	153796433	153795696	153796508	JUNC00006215	5	+	57	75	-304.0	-304.0	-304.0
chrX	153795804	153795927	153795751	153795982	JUNC00006217	4	+	53	55	-304.0	-304.0	-304.0
chrX	153795804	153796433	153795750	153796454	JUNC00006216	1	+	54	21	-304.0	-304.0	-304.0
chrX	153795856	153796433	153795810	153796500	JUNC00006218	7	+	46	67	-304.0	-304.0	-304.0
chrX	153796552	153797457	153796477	153797532	JUNC00006219	1185	+	75	75	-304.0	-304.0	-304.0
chrX	153796552	153797724	153796477	153797799	JUNC00006220	21	+	75	75	-304.0	-304.0	-304.0
chrX	153797532	153797724	153797457	153797799	JUNC00006221	1311	+	75	75	-304.0	-304.0	-304.0
chrX	153797814	153798070	153797739	153798144	JUNC00006222	1035	+	75	74	-304.0	-304.0	-304.0
chrX	153798136	153798328	153798068	153798403	JUNC00006223	587	+	68	75	-304.0	-304.0	-304.0
chrX	153862894	153863476	153862844	153863502	JUNC00006224	1	-	50	26	-304.0	-304.0	-304.0
chrX	153863549	153863882	153863509	153863918	JUNC00006225	1	-	40	36	-304.0	-304.0	-304.0
chrX	153864704	153864820	153864648	153864839	JUNC00006226	1	-	56	19	-304.0	-304.0	-304.0
chrX	153864994	153865087	153864937	153865106	JUNC00006227	1	-	57	19	-304.0	-304.0	-304.0
chrX	153867553	153867799	153867533	153867855	JUNC00006228	1	-	20	56	-304.0	-304.0	-304.0
chrX	153868727	153868840	153868681	153868898	JUNC00006229	2	-	46	58	-304.0	-304.0	-304.0
chrX	153869663	153869802	153869624	153869854	JUNC00006230	2	-	39	52	-304.0	-304.0	-304.0
chrX	153871179	153872151	153871147	153872195	JUNC00006231	1	-	32	44	-304.0	-304.0	-304.0
chrX	153872697	153875760	153872670	153875809	JUNC00006232	1	-	27	49	-304.0	-304.0	-304.0
chrX	153891626	153975607	153891600	153975657	JUNC00006233	1	+	26	50	62.0	-304.0	62.0
chrX	153907962	153909069	153907889	153909144	JUNC00006234	149	-	73	75	-304.0	-304.0	-304.0
chrX	153909169	153909442	153909094	153909517	JUNC00006235	176	-	75	75	-304.0	-304.0	-304.0
chrX	153909169	153909740	153909141	153909788	JUNC00006236	1	-	28	48	-304.0	-304.0	-304.0
chrX	153909535	153909740	153909461	153909803	JUNC00006237	44	-	74	63	-304.0	-304.0	-304.0
chrX	153909924	153910011	153909849	153910086	JUNC00006238	57	-	75	75	-304.0	-304.0	-304.0
chrX	153910085	153910170	153910011	153910245	JUNC00006239	39	-	74	75	-304.0	-304.0	-304.0
chrX	153910085	153910505	153910038	153910536	JUNC00006240	2	-	47	31	-304.0	-304.0	-304.0
chrX	153910404	153910505	153910334	153910579	JUNC00006241	14	-	70	74	-304.0	-304.0	-304.0
chrX	153910611	153910699	153910549	153910770	JUNC00006242	62	-	62	71	-304.0	-304.0	-304.0
chrX	153910834	153910921	153910759	153910996	JUNC00006243	176	-	75	75	-304.0	-304.0	-304.0
chrX	153910999	153911128	153910925	153911200	JUNC00006244	136	-	74	72	-304.0	-304.0	-304.0
chrX	153910999	153912699	153910928	153912774	JUNC00006245	4	-	71	75	-304.0	-304.0	-304.0
chrX	153911017	153911128	153910997	153911184	JUNC00006247	1	-	20	56	-304.0	-304.0	-304.0
chrX	153911189	153912699	153911128	153912773	JUNC00006246	157	-	61	74	-304.0	-304.0	-304.0
chrX	153911189	153913023	153911158	153913051	JUNC00006248	2	-	31	28	-304.0	-304.0	-304.0
chrX	153911563	153912699	153911510	153912773	JUNC00006250	2	-	53	74	-304.0	-304.0	-304.0
chrX	153912795	153913023	153912739	153913043	JUNC00006252	1	-	56	20	-304.0	-304.0	-304.0
chrX	153912802	153913023	153912730	153913077	JUNC00006251	134	-	72	54	-304.0	-304.0	-304.0
chrX	153913051	153913217	153913022	153913292	JUNC00006249	156	-	29	75	-304.0	-304.0	-304.0
chrX	153913302	153913408	153913228	153913481	JUNC00006253	87	-	74	73	-304.0	-304.0	-304.0
chrX	153913516	153913777	153913461	153913798	JUNC00006254	1	-	55	21	-304.0	-304.0	-304.0
chrX	153913600	153913777	153913525	153913852	JUNC00006255	173	-	75	75	-304.0	-304.0	-304.0
chrX	153913600	153918831	153913566	153918872	JUNC00006256	1	-	34	41	-304.0	-304.0	-304.0
chrX	153913879	153918831	153913805	153918903	JUNC00006257	180	-	74	72	-304.0	-304.0	-304.0
chrX	153919053	153919154	153918978	153919229	JUNC00006258	139	-	75	75	-304.0	-304.0	-304.0
chrX	153919283	153919566	153919228	153919640	JUNC00006260	10	-	55	74	-304.0	-304.0	-304.0
chrX	153919283	153920625	153919210	153920699	JUNC00006259	81	-	73	74	-304.0	-304.0	-304.0
chrX	153919686	153920625	153919643	153920695	JUNC00006261	6	-	43	70	-304.0	-304.0	-304.0
chrX	153920808	153921096	153920734	153921166	JUNC00006262	104	-	74	70	-304.0	-304.0	-304.0
chrX	153921159	153921364	153921095	153921438	JUNC00006263	82	-	64	74	-304.0	-304.0	-304.0
chrX	153921527	153921604	153921453	153921679	JUNC00006264	15	-	74	75	-304.0	-304.0	-304.0
chrX	153921809	153926135	153921757	153926169	JUNC00006265	3	-	52	34	-304.0	-304.0	-304.0
chrX	153921809	153926589	153921785	153926644	JUNC00006266	2	-	24	55	-304.0	-304.0	-304.0
chrX	153925874	153926135	153925821	153926158	JUNC00006267	1	-	53	23	-304.0	-304.0	-304.0
chrX	153930223	153930762	153930148	153930837	JUNC00006268	372	-	75	75	-304.0	-304.0	-304.0
chrX	153930847	153932070	153930772	153932145	JUNC00006269	305	-	75	75	-304.0	-304.0	-304.0
chrX	153932115	153932315	153932069	153932388	JUNC00006270	322	-	46	73	-304.0	-304.0	-304.0
chrX	153932431	153932538	153932356	153932596	JUNC00006271	269	-	75	58	-304.0	-304.0	-304.0
chrX	153932584	153933942	153932537	153934005	JUNC00006272	308	-	47	63	-304.0	-304.0	-304.0
chrX	153932584	153933960	153932538	153934001	JUNC00006273	9	-	46	41	-304.0	-304.0	-304.0
chrX	153932584	153934376	153932560	153934435	JUNC00006275	2	-	24	59	-304.0	-304.0	-304.0
chrX	153934001	153934376	153933941	153934449	JUNC00006274	237	-	60	73	-304.0	-304.0	-304.0
chrX	153934475	153934883	153934400	153934958	JUNC00006276	164	-	75	75	-304.0	-304.0	-304.0
chrX	153935404	153935488	153935339	153935560	JUNC00006277	13	-	65	72	-304.0	-304.0	-304.0
chrX	153935576	153936003	153935538	153936041	JUNC00006279	1	-	38	38	-304.0	-304.0	-304.0
chrX	153935576	153940101	153935502	153940171	JUNC00006278	14	-	74	70	-304.0	-304.0	-304.0
chrX	153940233	153941477	153940165	153941550	JUNC00006280	24	-	68	73	-304.0	-304.0	-304.0
chrX	153941653	153941949	153941579	153942024	JUNC00006281	30	-	74	75	-304.0	-304.0	-304.0
chrX	153942031	153942854	153941956	153942927	JUNC00006282	27	-	75	73	-304.0	-304.0	-304.0
chrX	153943079	153943545	153943004	153943619	JUNC00006283	11	-	75	74	-304.0	-304.0	-304.0
chrX	153943718	153943894	153943653	153943965	JUNC00006284	26	-	65	71	-304.0	-304.0	-304.0
chrX	153943970	153944079	153943897	153944148	JUNC00006285	26	-	73	69	-304.0	-304.0	-304.0
chrX	153944155	153944308	153944080	153944382	JUNC00006286	20	-	75	74	-304.0	-304.0	-304.0
chrX	153944418	153944583	153944344	153944651	JUNC00006287	20	-	74	68	-304.0	-304.0	-304.0
chrX	153949386	153949552	153949312	153949617	JUNC00006288	106	-	74	65	-304.0	-304.0	-304.0
chrX	153949616	153950242	153949552	153950317	JUNC00006289	159	-	64	75	-304.0	-304.0	-304.0
chrX	153950543	153950812	153950471	153950887	JUNC00006290	115	-	72	75	-304.0	-304.0	-304.0
chrX	153950998	153951349	153950923	153951424	JUNC00006291	138	-	75	75	-304.0	-304.0	-304.0
chrX	153951487	153951579	153951416	153951632	JUNC00006293	4	-	71	53	-304.0	-304.0	-304.0
chrX	153951487	153951588	153951413	153951663	JUNC00006292	90	-	74	75	-304.0	-304.0	-304.0
chrX	153951707	153951840	153951635	153951912	JUNC00006294	64	-	72	72	-304.0	-304.0	-304.0
chrX	153952158	153952513	153952090	153952531	JUNC00006295	3	-	68	18	-304.0	-304.0	-304.0
chrX	153952958	153953606	153952892	153953681	JUNC00006296	32	-	66	75	-304.0	-304.0	-304.0
chrX	153953090	153953606	153953016	153953681	JUNC00006297	19	-	74	75	-304.0	-304.0	-304.0
chrX	153953770	153954065	153953695	153954137	JUNC00006298	99	-	75	72	-304.0	-304.0	-304.0
chrX	153955042	153955129	153954974	153955179	JUNC00006299	5	?	68	50	-304.0	-304.0	-304.0
chrX	153955542	153956190	153955467	153956265	JUNC00006300	73	-	75	75	-304.0	-304.0	-304.0
chrX	153955542	153956624	153955492	153956650	JUNC00006301	1	-	50	26	-304.0	-304.0	-304.0
chrX	153956411	153956624	153956338	153956697	JUNC00006302	100	-	73	73	-304.0	-304.0	-304.0
chrX	153956763	153956917	153956692	153956992	JUNC00006303	82	-	71	75	-304.0	-304.0	-304.0
chrX	153957060	153957313	153956985	153957388	JUNC00006304	157	-	75	75	-304.0	-304.0	-304.0
chrX	153957533	153957781	153957458	153957856	JUNC00006305	110	-	75	75	-304.0	-304.0	-304.0
chrX	153957886	153958024	153957811	153958098	JUNC00006306	111	-	75	74	-304.0	-304.0	-304.0
chrX	153958249	153958568	153958174	153958643	JUNC00006307	71	-	75	75	-304.0	-304.0	-304.0
chrX	153958249	153959330	153958210	153959403	JUNC00006308	3	-	39	73	-304.0	-304.0	-304.0
chrX	153958766	153958955	153958715	153958980	JUNC00006310	1	-	51	25	-304.0	-304.0	-304.0
chrX	153958766	153959330	153958691	153959405	JUNC00006309	62	-	75	75	-304.0	-304.0	-304.0
chrX	153959470	153959801	153959395	153959872	JUNC00006311	5	-	75	71	-304.0	-304.0	-304.0
chrX	153959491	153959801	153959416	153959876	JUNC00006312	98	-	75	75	-304.0	-304.0	-304.0
chrX	153960161	153960234	153960086	153960309	JUNC00006313	105	-	75	75	-304.0	-304.0	-304.0
chrX	153960414	153961541	153960339	153961616	JUNC00006314	97	-	75	75	-304.0	-304.0	-304.0
chrX	153961648	153962221	153961574	153962296	JUNC00006315	112	-	74	75	-304.0	-304.0	-304.0
chrX	153962306	153963224	153962231	153963299	JUNC00006316	68	-	75	75	-304.0	-304.0	-304.0
chrX	153963433	153964123	153963361	153964198	JUNC00006317	99	-	72	75	-304.0	-304.0	-304.0
chrX	153964284	153964577	153964209	153964652	JUNC00006318	112	-	75	75	-304.0	-304.0	-304.0
chrX	153964726	153967504	153964651	153967559	JUNC00006320	2	-	75	55	-304.0	-304.0	-304.0
chrX	153964726	153969267	153964651	153969313	JUNC00006319	2	-	75	46	-304.0	-304.0	-304.0
chrX	153964726	153970647	153964651	153970718	JUNC00006321	73	-	75	71	-304.0	-304.0	-304.0
chrX	153972860	153981849	153972791	153981919	JUNC00006322	9	+	69	70	-304.0	-304.0	-304.0
chrX	153975726	153978868	153975687	153978903	JUNC00006323	1	-	39	35	-304.0	-304.0	-304.0
chrX	153980623	153981849	153980567	153981912	JUNC00006324	4	+	56	63	-304.0	-304.0	-304.0
chrX	154011917	154012244	154011843	154012277	JUNC00006326	7	-	74	33	-304.0	-304.0	-304.0
chrX	154011917	154012528	154011843	154012601	JUNC00006325	167	-	74	73	-304.0	-304.0	-304.0
chrX	154011917	154012584	154011888	154012631	JUNC00006328	1	-	29	47	-304.0	-304.0	-304.0
chrX	154011917	154013042	154011870	154013071	JUNC00006327	1	-	47	29	-304.0	-304.0	-304.0
chrX	154012678	154012983	154012619	154013000	JUNC00006330	1	-	59	17	-304.0	-304.0	-304.0
chrX	154012678	154013042	154012603	154013117	JUNC00006329	146	-	75	75	-304.0	-304.0	-304.0
chrX	154013343	154014041	154013268	154014101	JUNC00006332	3	-	75	60	-304.0	-304.0	-304.0
chrX	154013343	154016031	154013268	154016061	JUNC00006331	2	-	75	30	-304.0	-304.0	-304.0
chrX	154013433	154014041	154013362	154014110	JUNC00006333	20	-	71	69	-304.0	-304.0	-304.0
chrX	154013433	154016031	154013384	154016056	JUNC00006334	1	-	49	25	-304.0	-304.0	-304.0
chrX	154014110	154014149	154014039	154014205	JUNC00006335	4	+	71	56	-304.0	-304.0	-304.0
chrX	154014278	154014408	154014228	154014434	JUNC00006338	1	-	50	26	-304.0	-304.0	-304.0
chrX	154014278	154016031	154014204	154016098	JUNC00006336	150	-	74	67	-304.0	-304.0	-304.0
chrX	154014278	154016436	154014221	154016470	JUNC00006337	2	-	57	34	-304.0	-304.0	-304.0
chrX	154016097	154016436	154016031	154016511	JUNC00006339	158	-	66	75	-304.0	-304.0	-304.0
chrX	154016644	154016948	154016570	154017023	JUNC00006340	174	-	74	75	-304.0	-304.0	-304.0
chrX	154017067	154018005	154016993	154018080	JUNC00006341	262	-	74	75	-304.0	-304.0	-304.0
chrX	154018120	154018290	154018046	154018357	JUNC00006342	357	-	74	67	-304.0	-304.0	-304.0
chrX	154018355	154018598	154018288	154018673	JUNC00006343	379	-	67	75	-304.0	-304.0	-304.0
chrX	154018754	154018974	154018679	154019041	JUNC00006344	7	-	75	67	-304.0	-304.0	-304.0
chrX	154018783	154018974	154018708	154018998	JUNC00006345	18	-	75	24	-304.0	-304.0	-304.0
chrX	154018787	154018974	154018712	154019049	JUNC00006346	199	-	75	75	-304.0	-304.0	-304.0
chrX	154019078	154019196	154019003	154019269	JUNC00006347	112	-	75	73	-304.0	-304.0	-304.0
chrX	154019328	154019430	154019277	154019494	JUNC00006348	8	-	51	64	-304.0	-304.0	-304.0
chrX	154019598	154019676	154019569	154019749	JUNC00006349	4	-	29	73	-304.0	-304.0	-304.0
chrX	154030936	154031203	154030861	154031237	JUNC00006350	6	-	75	34	-304.0	-304.0	-304.0
chrX	154031286	154031395	154031234	154031440	JUNC00006351	2	-	52	45	-304.0	-304.0	-304.0
chrX	154031450	154032206	154031376	154032281	JUNC00006352	75	-	74	75	-304.0	-304.0	-304.0
chrX	154032557	154048516	154032483	154048555	JUNC00006354	2	-	74	39	-304.0	-304.0	-304.0
chrX	154032557	154057742	154032483	154057805	JUNC00006355	3	-	74	63	-304.0	-304.0	-304.0
chrX	154032557	154092183	154032482	154092257	JUNC00006353	42	-	75	74	-304.0	-304.0	-304.0
chrX	154032557	154097603	154032525	154097647	JUNC00006356	1	-	32	44	-304.0	-304.0	-304.0
chrX	154055759	154088749	154055719	154088785	JUNC00006357	1	-	40	36	-304.0	-304.0	-304.0
chrX	154058535	154092183	154058518	154092242	JUNC00006358	1	-	17	59	-304.0	-304.0	-304.0
chrX	154091181	154092183	154091121	154092228	JUNC00006359	6	-	60	45	-304.0	-304.0	-304.0
chrX	154092307	154094377	154092275	154094421	JUNC00006361	1	-	32	44	-304.0	-304.0	-304.0
chrX	154092307	154097603	154092233	154097676	JUNC00006360	16	-	74	73	-304.0	-304.0	-304.0
chrX	154214450	154314667	154214426	154314716	JUNC00006362	1	+	24	49	-304.0	-304.0	-304.0
chrX	154252252	154314667	154252228	154314716	JUNC00006363	1	+	24	49	-304.0	-304.0	-304.0
chrX	154315337	154320756	154315296	154320791	JUNC00006364	1	+	41	35	-304.0	-304.0	-304.0
chrX	154334241	154334393	154334214	154334442	JUNC00006365	1	+	27	49	-304.0	-304.0	-304.0
chrX	154349036	154349361	154348961	154349436	JUNC00006366	486	-	75	75	-304.0	-304.0	-304.0
chrX	154349564	154349648	154349508	154349668	JUNC00006368	1	?	56	20	-304.0	-304.0	-304.0
chrX	154349565	154349648	154349490	154349723	JUNC00006367	814	-	75	75	-304.0	-304.0	-304.0
chrX	154349867	154350030	154349792	154350105	JUNC00006369	1245	-	75	75	-304.0	-304.0	-304.0
chrX	154350207	154350908	154350132	154350983	JUNC00006370	897	-	75	75	-304.0	-304.0	-304.0
chrX	154351041	154351580	154350966	154351655	JUNC00006371	680	-	75	75	-304.0	-304.0	-304.0
chrX	154351696	154351883	154351621	154351958	JUNC00006372	1004	-	75	75	-304.0	-304.0	-304.0
chrX	154352021	154352180	154351946	154352255	JUNC00006373	650	-	75	75	-304.0	-304.0	-304.0
chrX	154352447	154352552	154352372	154352627	JUNC00006374	776	-	75	75	-304.0	-304.0	-304.0
chrX	154352675	154352771	154352600	154352846	JUNC00006375	827	-	75	75	-304.0	-304.0	-304.0
chrX	154352924	154353000	154352849	154353075	JUNC00006376	900	-	75	75	-304.0	-304.0	-304.0
chrX	154352941	154353000	154352906	154353075	JUNC00006377	18	-	35	75	-304.0	-304.0	-304.0
chrX	154353204	154353295	154353129	154353370	JUNC00006378	624	-	75	75	-304.0	-304.0	-304.0
chrX	154353457	154353553	154353382	154353628	JUNC00006379	844	-	75	75	-304.0	-304.0	-304.0
chrX	154353457	154353914	154353382	154353989	JUNC00006380	32	-	75	75	-304.0	-304.0	-304.0
chrX	154353457	154354150	154353382	154354225	JUNC00006381	20	-	75	75	-304.0	-304.0	-304.0
chrX	154353727	154353914	154353652	154353989	JUNC00006382	997	-	75	75	-304.0	-304.0	-304.0
chrX	154354043	154354150	154353968	154354225	JUNC00006383	877	-	75	75	-304.0	-304.0	-304.0
chrX	154354291	154354380	154354216	154354455	JUNC00006384	656	-	75	75	-304.0	-304.0	-304.0
chrX	154354483	154354615	154354408	154354690	JUNC00006385	446	-	75	75	-304.0	-304.0	-304.0
chrX	154354483	154354824	154354409	154354899	JUNC00006386	28	-	74	75	-304.0	-304.0	-304.0
chrX	154354711	154354824	154354636	154354899	JUNC00006387	655	-	75	75	-304.0	-304.0	-304.0
chrX	154355072	154357250	154354997	154357277	JUNC00006388	480	-	75	27	-304.0	-304.0	-304.0
chrX	154355072	154357433	154354997	154357508	JUNC00006389	347	-	75	75	-304.0	-304.0	-304.0
chrX	154357274	154357433	154357248	154357508	JUNC00006390	395	-	26	75	-304.0	-304.0	-304.0
chrX	154357623	154358198	154357548	154358273	JUNC00006391	833	-	75	75	-304.0	-304.0	-304.0
chrX	154358355	154358444	154358280	154358519	JUNC00006392	702	-	75	75	-304.0	-304.0	-304.0
chrX	154358568	154358983	154358493	154359057	JUNC00006393	817	-	75	74	-304.0	-304.0	-304.0
chrX	154359154	154359245	154359079	154359320	JUNC00006394	727	-	75	75	-304.0	-304.0	-304.0
chrX	154359406	154359483	154359331	154359557	JUNC00006395	293	-	75	74	-304.0	-304.0	-304.0
chrX	154359646	154359731	154359571	154359806	JUNC00006396	299	-	75	75	-304.0	-304.0	-304.0
chrX	154359905	154359989	154359830	154360064	JUNC00006397	541	-	75	75	-304.0	-304.0	-304.0
chrX	154360116	154360357	154360046	154360402	JUNC00006398	2	?	70	45	-304.0	-304.0	-304.0
chrX	154360587	154361307	154360514	154361382	JUNC00006399	271	-	73	75	-304.0	-304.0	-304.0
chrX	154361570	154361669	154361496	154361744	JUNC00006400	789	-	74	75	-304.0	-304.0	-304.0
chrX	154361787	154361978	154361712	154362053	JUNC00006401	736	-	75	75	-304.0	-304.0	-304.0
chrX	154362148	154362241	154362073	154362315	JUNC00006402	623	-	75	74	-304.0	-304.0	-304.0
chrX	154362332	154362417	154362257	154362492	JUNC00006403	459	-	75	75	-304.0	-304.0	-304.0
chrX	154362578	154362660	154362503	154362735	JUNC00006404	527	-	75	75	-304.0	-304.0	-304.0
chrX	154362784	154364021	154362709	154364095	JUNC00006405	493	-	75	74	-304.0	-304.0	-304.0
chrX	154364165	154364258	154364090	154364333	JUNC00006406	709	-	75	75	-304.0	-304.0	-304.0
chrX	154364372	154364525	154364297	154364600	JUNC00006407	765	-	75	75	-304.0	-304.0	-304.0
chrX	154364719	154364820	154364644	154364895	JUNC00006408	744	-	75	75	-304.0	-304.0	-304.0
chrX	154364957	154365135	154364882	154365210	JUNC00006409	860	-	75	75	-304.0	-304.0	-304.0
chrX	154365259	154365348	154365184	154365423	JUNC00006410	818	-	75	75	-304.0	-304.0	-304.0
chrX	154365486	154365744	154365411	154365801	JUNC00006411	9	-	75	57	-304.0	-304.0	-304.0
chrX	154365486	154366023	154365411	154366098	JUNC00006412	185	-	75	75	-304.0	-304.0	-304.0
chrX	154365486	154366307	154365424	154366369	JUNC00006413	5	-	62	62	-304.0	-304.0	-304.0
chrX	154366221	154366307	154366147	154366350	JUNC00006414	7	-	74	43	-304.0	-304.0	-304.0
chrX	154366224	154366307	154366149	154366382	JUNC00006415	509	-	75	75	-304.0	-304.0	-304.0
chrX	154366446	154366561	154366371	154366579	JUNC00006416	14	-	75	18	-304.0	-304.0	-304.0
chrX	154366470	154366561	154366395	154366636	JUNC00006417	804	-	75	75	-304.0	-304.0	-304.0
chrX	154366639	154366731	154366564	154366806	JUNC00006418	810	-	75	75	-304.0	-304.0	-304.0
chrX	154366850	154367396	154366775	154367471	JUNC00006419	814	-	75	75	-304.0	-304.0	-304.0
chrX	154367544	154367640	154367469	154367715	JUNC00006420	531	-	75	75	-304.0	-304.0	-304.0
chrX	154367738	154367841	154367663	154367916	JUNC00006421	176	-	75	75	-304.0	-304.0	-304.0
chrX	154368090	154370872	154368015	154370947	JUNC00006422	648	-	75	75	-304.0	-304.0	-304.0
chrX	154371361	154374505	154371287	154374542	JUNC00006423	4	-	74	37	-304.0	-304.0	-304.0
chrX	154374727	154376387	154374686	154376438	JUNC00006424	2	+	41	51	-304.0	-304.0	-304.0
chrX	154376559	154379271	154376514	154379302	JUNC00006425	1	+	45	31	-304.0	-304.0	-304.0
chrX	154379537	154379689	154379489	154379761	JUNC00006426	4	+	48	72	-304.0	-304.0	-304.0
chrX	154379566	154379689	154379491	154379762	JUNC00006427	157	+	75	73	-304.0	-304.0	-304.0
chrX	154379794	154379941	154379730	154380016	JUNC00006428	186	+	64	75	-304.0	-304.0	-304.0
chrX	154380019	154380233	154379944	154380304	JUNC00006429	235	+	75	71	-304.0	-304.0	-304.0
chrX	154380019	154380276	154379944	154380345	JUNC00006430	6	+	75	69	-304.0	-304.0	-304.0
chrX	154380367	154380752	154380292	154380814	JUNC00006431	244	+	75	62	-304.0	-304.0	-304.0
chrX	154380398	154380752	154380375	154380805	JUNC00006433	4	+	23	53	-304.0	-304.0	-304.0
chrX	154380802	154380881	154380741	154380956	JUNC00006432	299	+	61	75	-304.0	-304.0	-304.0
chrX	154398394	154398496	154398319	154398569	JUNC00006434	755	+	75	73	-304.0	-304.0	-304.0
chrX	154398542	154399337	154398469	154399407	JUNC00006435	4209	+	73	70	-304.0	-304.0	-304.0
chrX	154399070	154399335	154399024	154399381	JUNC00006438	2	?	46	46	-304.0	-304.0	-304.0
chrX	154399103	154399337	154399083	154399393	JUNC00006440	1	+	20	56	-304.0	-304.0	-304.0
chrX	154399113	154399337	154399048	154399391	JUNC00006439	6	+	65	54	-304.0	-304.0	-304.0
chrX	154399366	154399525	154399337	154399528	JUNC00006436	1	+	29	3	-304.0	-304.0	-304.0
chrX	154399366	154399525	154399342	154399577	JUNC00006442	1	?	24	52	-304.0	-304.0	-304.0
chrX	154399373	154399496	154399353	154399552	JUNC00006443	1	?	20	56	-304.0	-304.0	-304.0
chrX	154399396	154399486	154399336	154399561	JUNC00006437	2281	+	60	75	-304.0	-304.0	-304.0
chrX	154399396	154399802	154399341	154399877	JUNC00006441	52	+	55	75	-304.0	-304.0	-304.0
chrX	154399563	154399865	154399488	154399940	JUNC00006444	32	?	75	75	-304.0	-304.0	-304.0
chrX	154399567	154399842	154399493	154399886	JUNC00006445	6	?	74	44	-304.0	-304.0	-304.0
chrX	154399580	154399810	154399505	154399845	JUNC00006446	58	+	75	35	-304.0	-304.0	-304.0
chrX	154399588	154399798	154399513	154399853	JUNC00006447	75	-	75	55	-304.0	-304.0	-304.0
chrX	154399594	154399802	154399519	154399877	JUNC00006448	3181	+	75	75	-304.0	-304.0	-304.0
chrX	154399594	154400463	154399549	154400538	JUNC00006449	31	+	45	75	-304.0	-304.0	-304.0
chrX	154399826	154399870	154399802	154399892	JUNC00006451	1	+	24	22	-304.0	-304.0	-304.0
chrX	154399826	154399893	154399802	154399931	JUNC00006450	2	+	24	38	-304.0	-304.0	-304.0
chrX	154399834	154399865	154399809	154399916	JUNC00006454	1	?	25	51	90.0	90.0	90.0
chrX	154399856	154399912	154399802	154399918	JUNC00006452	2	+	54	6	-304.0	-304.0	-304.0
chrX	154399856	154399912	154399806	154399938	JUNC00006453	1	?	50	26	-304.0	-304.0	-304.0
chrX	154399941	154400463	154399866	154400538	JUNC00006455	9985	+	75	75	-304.0	-304.0	-304.0
chrX	154399941	154400474	154399866	154400549	JUNC00006456	522	+	75	75	-304.0	-304.0	-304.0
chrX	154399941	154400557	154399883	154400626	JUNC00006458	141	+	58	69	-304.0	-304.0	-304.0
chrX	154399941	154400701	154399868	154400776	JUNC00006457	252	+	73	75	-304.0	-304.0	-304.0
chrX	154400358	154400463	154400339	154400538	JUNC00006462	39	+	19	75	-304.0	-304.0	-304.0
chrX	154400533	154400608	154400475	154400626	JUNC00006463	1	+	58	18	-304.0	-304.0	-304.0
chrX	154400545	154400707	154400471	154400779	JUNC00006459	47	+	74	72	-304.0	-304.0	-304.0
chrX	154400626	154400701	154400551	154400776	JUNC00006460	6668	+	75	75	-304.0	-304.0	-304.0
chrX	154400626	154400716	154400551	154400791	JUNC00006461	157	+	75	75	-304.0	-304.0	-304.0
chrX	154400727	154400756	154400701	154400757	JUNC00006464	1	+	26	1	-304.0	94.0	94.0
chrX	154400727	154400756	154400701	154400806	JUNC00006465	1	?	26	50	-304.0	94.0	94.0
chrX	154402841	154402941	154402766	154403015	JUNC00006466	18	-	75	74	-304.0	-304.0	-304.0
chrX	154403190	154403268	154403115	154403343	JUNC00006467	56	-	75	75	-304.0	-304.0	-304.0
chrX	154403381	154403521	154403310	154403596	JUNC00006468	65	-	71	75	-304.0	-304.0	-304.0
chrX	154403622	154404827	154403553	154404901	JUNC00006469	40	-	69	74	-304.0	-304.0	-304.0
chrX	154404914	154404994	154404840	154405067	JUNC00006470	62	-	74	73	-304.0	-304.0	-304.0
chrX	154405083	154405433	154405010	154405507	JUNC00006471	35	-	73	74	-304.0	-304.0	-304.0
chrX	154405655	154408557	154405580	154408580	JUNC00006473	3	-	75	23	-304.0	-304.0	-304.0
chrX	154405655	154409111	154405580	154409186	JUNC00006472	29	-	75	75	-304.0	-304.0	-304.0
chrX	154409196	154409417	154409124	154409478	JUNC00006474	8	-	72	61	-304.0	-304.0	-304.0
chrX	154409196	154411890	154409150	154411920	JUNC00006475	1	-	46	30	-304.0	-304.0	-304.0
chrX	154409675	154411890	154409619	154411959	JUNC00006476	8	-	56	69	-304.0	-304.0	-304.0
chrX	154409813	154411890	154409767	154411920	JUNC00006477	1	-	46	30	-304.0	-304.0	-304.0
chrX	154411357	154411890	154411285	154411913	JUNC00006478	2	-	72	23	-304.0	-304.0	-304.0
chrX	154411952	154412085	154411880	154412155	JUNC00006479	19	+	72	70	-304.0	-304.0	-304.0
chrX	154412006	154412085	154411966	154412154	JUNC00006480	3	+	40	69	-304.0	-304.0	-304.0
chrX	154412214	154413206	154412146	154413268	JUNC00006481	55	+	68	62	-304.0	-304.0	-304.0
chrX	154412974	154413206	154412944	154413252	JUNC00006483	2	+	30	46	-304.0	-304.0	-304.0
chrX	154413252	154413481	154413206	154413554	JUNC00006482	56	+	46	73	-304.0	-304.0	-304.0
chrX	154413339	154413481	154413278	154413530	JUNC00006484	4	+	61	49	-304.0	-304.0	-304.0
chrX	154413358	154413481	154413285	154413549	JUNC00006485	5	+	73	68	-304.0	-304.0	-304.0
chrX	154413567	154414100	154413515	154414174	JUNC00006487	33	+	52	74	-304.0	-304.0	-304.0
chrX	154413567	154419542	154413493	154419617	JUNC00006486	53	+	74	75	-304.0	-304.0	-304.0
chrX	154414190	154418545	154414150	154418581	JUNC00006489	1	+	40	36	-304.0	-304.0	-304.0
chrX	154414190	154419542	154414115	154419617	JUNC00006488	43	+	75	75	-304.0	-304.0	-304.0
chrX	154419623	154419704	154419549	154419779	JUNC00006490	34	+	74	75	-304.0	-304.0	-304.0
chrX	154419623	154420031	154419568	154420094	JUNC00006491	11	+	55	63	-304.0	-304.0	-304.0
chrX	154419746	154420031	154419698	154420106	JUNC00006492	41	+	48	75	-304.0	-304.0	-304.0
chrX	154420094	154420211	154420021	154420264	JUNC00006493	96	+	73	53	-304.0	-304.0	-304.0
chrX	154420264	154420657	154420208	154420732	JUNC00006494	98	+	56	75	-304.0	-304.0	-304.0
chrX	154420459	154420657	154420416	154420732	JUNC00006495	6	+	43	75	-304.0	-304.0	-304.0
chrX	154420735	154420902	154420660	154420976	JUNC00006496	109	+	75	74	-304.0	-304.0	-304.0
chrX	154424625	154426908	154424567	154426926	JUNC00006498	1	-	58	18	-304.0	-304.0	-304.0
chrX	154424625	154428127	154424558	154428197	JUNC00006497	19	-	67	70	-304.0	-304.0	-304.0
chrX	154428853	154429047	154428807	154429122	JUNC00006499	45	+	46	75	-304.0	-304.0	-304.0
chrX	154429174	154431829	154429100	154431904	JUNC00006500	128	+	74	75	-304.0	-304.0	-304.0
chrX	154431657	154431829	154431615	154431861	JUNC00006501	1	+	42	32	-304.0	-304.0	-304.0
chrX	154431904	154432265	154431829	154432339	JUNC00006502	143	+	75	74	-304.0	-304.0	-304.0
chrX	154432459	154432930	154432384	154432971	JUNC00006503	119	+	75	41	-304.0	-304.0	-304.0
chrX	154432971	154433634	154432928	154433708	JUNC00006504	123	+	43	74	-304.0	-304.0	-304.0
chrX	154433720	154434207	154433647	154434281	JUNC00006505	85	+	73	74	-304.0	-304.0	-304.0
chrX	154434294	154435138	154434239	154435159	JUNC00006506	1	+	55	21	-304.0	-304.0	-304.0
chrX	154434731	154434862	154434697	154434904	JUNC00006507	1	?	34	42	-304.0	-304.0	-304.0
chrX	154435186	154435273	154435135	154435348	JUNC00006508	217	+	51	75	-304.0	-304.0	-304.0
chrX	154435505	154435681	154435430	154435754	JUNC00006509	164	+	75	73	-304.0	-304.0	-304.0
chrX	154437299	154438522	154437224	154438597	JUNC00006510	203	+	75	75	-304.0	-304.0	-304.0
chrX	154438630	154438764	154438555	154438839	JUNC00006511	232	+	75	75	-304.0	-304.0	-304.0
chrX	154438864	154439005	154438789	154439079	JUNC00006512	160	+	75	74	-304.0	-304.0	-304.0
chrX	154438864	154439035	154438828	154439110	JUNC00006513	2	+	36	75	-304.0	-304.0	-304.0
chrX	154439140	154439940	154439065	154440015	JUNC00006514	275	+	75	75	-304.0	-304.0	-304.0
chrX	154440129	154440374	154440078	154440399	JUNC00006516	1	+	51	25	-304.0	-304.0	-304.0
chrX	154440139	154440374	154440064	154440447	JUNC00006515	165	+	75	73	-304.0	-304.0	-304.0
chrX	154440506	154440885	154440472	154440926	JUNC00006518	1	+	34	41	-304.0	-304.0	-304.0
chrX	154440506	154441095	154440431	154441170	JUNC00006517	228	+	75	75	-304.0	-304.0	-304.0
chrX	154441195	154441536	154441163	154441580	JUNC00006520	1	+	32	44	-304.0	-304.0	-304.0
chrX	154441195	154441622	154441120	154441697	JUNC00006519	266	+	75	75	-304.0	-304.0	-304.0
chrX	154441794	154442110	154441719	154442183	JUNC00006521	295	+	75	73	-304.0	-304.0	-304.0
chrX	154442255	154442373	154442180	154442429	JUNC00006522	234	+	75	56	-304.0	-304.0	-304.0
chrX	154442428	154442519	154442373	154442594	JUNC00006523	254	+	55	75	-304.0	-304.0	-304.0
chrX	154442430	154442522	154442393	154442561	JUNC00006524	1	?	37	39	-304.0	-304.0	-304.0
chrX	154444346	154445632	154444271	154445707	JUNC00006525	141	+	75	75	-304.0	-304.0	-304.0
chrX	154445717	154445811	154445642	154445885	JUNC00006526	263	+	75	74	-304.0	-304.0	-304.0
chrX	154445911	154446414	154445836	154446489	JUNC00006527	321	+	75	75	-304.0	-304.0	-304.0
chrX	154446560	154448483	154446485	154448558	JUNC00006528	247	+	75	75	-304.0	-304.0	-304.0
chrX	154448560	154448689	154448485	154448761	JUNC00006529	318	+	75	72	-304.0	-304.0	-304.0
chrX	154448756	154448892	154448688	154448963	JUNC00006530	318	+	68	71	-304.0	-304.0	-304.0
chrX	154448954	154449220	154448892	154449295	JUNC00006531	285	+	62	75	-304.0	-304.0	-304.0
chrX	154449287	154449680	154449220	154449714	JUNC00006532	2	+	67	34	-304.0	-304.0	-304.0
chrX	154449297	154449680	154449222	154449752	JUNC00006533	259	+	75	72	-304.0	-304.0	-304.0
chrX	154449735	154449882	154449665	154449932	JUNC00006534	282	+	70	50	-304.0	-304.0	-304.0
chrX	154449735	154449915	154449699	154449931	JUNC00006535	1	+	36	16	-304.0	-304.0	-304.0
chrX	154449931	154450028	154449865	154450099	JUNC00006536	265	+	66	71	-304.0	-304.0	-304.0
chrX	154450099	154450208	154450027	154450283	JUNC00006537	281	+	72	75	-304.0	-304.0	-304.0
chrX	154450319	154450423	154450245	154450497	JUNC00006538	132	+	74	74	-304.0	-304.0	-304.0
chrX	154456854	154493643	154456809	154493674	JUNC00006539	1	+	45	31	-304.0	-304.0	-304.0
chrX	154460777	154461098	154460717	154461169	JUNC00006540	5	+	60	71	-304.0	-304.0	-304.0
chrX	154461638	154462127	154461568	154462199	JUNC00006541	9	+	70	72	-304.0	-304.0	-304.0
chrX	154462310	154463390	154462235	154463465	JUNC00006542	5	+	75	75	-304.0	-304.0	-304.0
chrX	154463519	154463589	154463444	154463660	JUNC00006543	12	+	75	71	-304.0	-304.0	-304.0
chrX	154463690	154463950	154463623	154463986	JUNC00006544	2	+	67	36	-304.0	-304.0	-304.0
chrX	154464074	154464156	154464038	154464228	JUNC00006545	3	+	36	72	-304.0	-304.0	-304.0
chrX	154464313	154464401	154464251	154464475	JUNC00006546	8	+	62	74	-304.0	-304.0	-304.0
chrX	154464501	154464753	154464469	154464797	JUNC00006547	1	+	32	44	-304.0	-304.0	-304.0
chrX	154464868	154465017	154464810	154465073	JUNC00006548	4	+	58	56	-304.0	-304.0	-304.0
chrX	154465218	154465423	154465167	154465485	JUNC00006549	4	+	51	62	-304.0	-304.0	-304.0
chrX	154465520	154465656	154465502	154465713	JUNC00006550	1	+	18	57	-304.0	-304.0	-304.0
chrX	154465847	154465934	154465794	154465984	JUNC00006551	6	+	53	50	-304.0	-304.0	-304.0
chrX	154466080	154466149	154466017	154466168	JUNC00006552	4	+	63	19	-304.0	-304.0	-304.0
chrX	154466270	154466375	154466196	154466447	JUNC00006553	13	+	74	72	-304.0	-304.0	-304.0
chrX	154466512	154466622	154466441	154466685	JUNC00006554	10	+	71	63	-304.0	-304.0	-304.0
chrX	154466512	154466721	154466489	154466774	JUNC00006555	1	+	23	53	-304.0	-304.0	-304.0
chrX	154466793	154467056	154466723	154467131	JUNC00006556	19	+	70	75	-304.0	-304.0	-304.0
chrX	154467150	154467231	154467081	154467272	JUNC00006557	4	+	69	41	-304.0	-304.0	-304.0
chrX	154467471	154467544	154467402	154467604	JUNC00006558	6	+	69	60	-304.0	-304.0	-304.0
chrX	154467688	154467766	154467632	154467823	JUNC00006559	3	+	56	57	-304.0	-304.0	-304.0
chrX	154468001	154468081	154467937	154468140	JUNC00006560	3	+	64	59	-304.0	-304.0	-304.0
chrX	154468224	154468302	154468158	154468371	JUNC00006561	8	+	66	69	-304.0	-304.0	-304.0
chrX	154468559	154468662	154468485	154468696	JUNC00006562	4	+	74	34	-304.0	-304.0	-304.0
chrX	154468729	154468822	154468663	154468895	JUNC00006563	11	+	66	73	-304.0	-304.0	-304.0
chrX	154468969	154469055	154468905	154469123	JUNC00006564	12	+	64	68	-304.0	-304.0	-304.0
chrX	154469215	154469378	154469156	154469450	JUNC00006565	9	+	59	72	-304.0	-304.0	-304.0
chrX	154469482	154469687	154469427	154469748	JUNC00006566	5	+	55	61	-304.0	-304.0	-304.0
chrX	154469482	154469976	154469457	154470027	JUNC00006567	1	+	25	51	-304.0	-304.0	-304.0
chrX	154469784	154469976	154469743	154470050	JUNC00006568	5	+	41	74	-304.0	-304.0	-304.0
chrX	154470167	154470441	154470094	154470513	JUNC00006569	12	+	73	72	-304.0	-304.0	-304.0
chrX	154470611	154470881	154470556	154470902	JUNC00006571	1	+	55	21	-304.0	-304.0	-304.0
chrX	154470611	154471104	154470539	154471179	JUNC00006570	8	+	72	75	-304.0	-304.0	-304.0
chrX	154471317	154471487	154471255	154471559	JUNC00006572	11	+	62	72	-304.0	-304.0	-304.0
chrX	154471638	154472589	154471572	154472660	JUNC00006573	10	+	66	71	-304.0	-304.0	-304.0
chrX	154476229	154481053	154476209	154481107	JUNC00006574	1	+	20	54	-304.0	-304.0	-304.0
chrX	154478058	154478282	154477984	154478356	JUNC00006575	112	-	74	74	-304.0	-304.0	-304.0
chrX	154478058	154478305	154478018	154478341	JUNC00006576	1	-	40	36	-304.0	-304.0	-304.0
chrX	154478411	154478727	154478336	154478791	JUNC00006577	35	-	75	64	-304.0	-304.0	-304.0
chrX	154485649	154485770	154485574	154485843	JUNC00006578	40	-	75	73	-304.0	-304.0	-304.0
chrX	154485979	154486227	154485905	154486302	JUNC00006579	52	-	74	75	-304.0	-304.0	-304.0
chrX	154486333	154486536	154486258	154486604	JUNC00006580	21	-	75	68	-304.0	-304.0	-304.0
chrX	154488496	154488583	154488443	154488622	JUNC00006581	3	-	53	39	-304.0	-304.0	-304.0
chrX	154489082	154489129	154489007	154489167	JUNC00006583	2	-	75	38	-304.0	-304.0	-304.0
chrX	154489082	154489941	154489007	154489979	JUNC00006584	2	-	75	38	-304.0	-304.0	-304.0
chrX	154489082	154489973	154489032	154490031	JUNC00006585	3	-	50	58	-304.0	-304.0	-304.0
chrX	154489082	154490306	154489007	154490379	JUNC00006582	29	-	75	73	-304.0	-304.0	-304.0
chrX	154490047	154490306	154490024	154490359	JUNC00006586	1	-	23	53	-304.0	-304.0	-304.0
chrX	154506906	154507202	154506831	154507276	JUNC00006587	93	-	75	74	-304.0	-304.0	-304.0
chrX	154507329	154507405	154507259	154507480	JUNC00006588	70	-	70	75	-304.0	-304.0	-304.0
chrX	154507490	154507810	154507415	154507882	JUNC00006589	69	-	75	72	-304.0	-304.0	-304.0
chrX	154507490	154508288	154507415	154508347	JUNC00006590	5	-	75	59	-304.0	-304.0	-304.0
chrX	154507861	154508288	154507808	154508347	JUNC00006591	35	-	53	59	-304.0	-304.0	-304.0
chrX	154507882	154508288	154507818	154508347	JUNC00006593	10	-	64	59	-304.0	-304.0	-304.0
chrX	154507885	154508288	154507860	154508339	JUNC00006594	1	-	25	51	-304.0	-304.0	-304.0
chrX	154508347	154508473	154508288	154508547	JUNC00006592	32	-	59	74	-304.0	-304.0	-304.0
chrX	154508597	154511847	154508530	154511872	JUNC00006595	54	-	67	25	-304.0	-304.0	-304.0
chrX	154508652	154511847	154508608	154511875	JUNC00006598	4	-	44	28	-304.0	-304.0	-304.0
chrX	154508768	154511847	154508719	154511871	JUNC00006599	3	-	49	24	-304.0	-304.0	-304.0
chrX	154511871	154512313	154511847	154512381	JUNC00006597	3	-	24	68	-304.0	-304.0	-304.0
chrX	154511871	154512822	154511832	154512894	JUNC00006596	73	-	39	72	-304.0	-304.0	-304.0
chrX	154512059	154512822	154512036	154512875	JUNC00006600	1	-	23	53	-304.0	-304.0	-304.0
chrX	154512411	154512822	154512343	154512883	JUNC00006601	9	-	68	61	-304.0	-304.0	-304.0
chrX	154512431	154512822	154512378	154512845	JUNC00006602	1	-	53	23	-304.0	-304.0	-304.0
chrX	154512936	154515759	154512861	154515831	JUNC00006603	69	-	75	72	-304.0	-304.0	-304.0
chrX	154515812	154515909	154515759	154515974	JUNC00006604	22	-	53	65	-304.0	-304.0	-304.0
chrX	154515812	154515910	154515774	154515948	JUNC00006605	1	?	38	38	-304.0	-304.0	-304.0
chrX	154515812	154515968	154515780	154516012	JUNC00006606	1	-	32	44	-304.0	-304.0	-304.0
chrX	154532090	154532187	154532017	154532262	JUNC00006607	114	-	73	75	-304.0	-304.0	-304.0
chrX	154532280	154532385	154532205	154532460	JUNC00006608	188	-	75	75	-304.0	-304.0	-304.0
chrX	154532462	154532566	154532388	154532641	JUNC00006609	166	-	74	75	-304.0	-304.0	-304.0
chrX	154532802	154532941	154532727	154533016	JUNC00006611	75	-	75	75	-304.0	-304.0	-304.0
chrX	154532802	154533575	154532727	154533649	JUNC00006610	5	-	75	74	-304.0	-304.0	-304.0
chrX	154533128	154533575	154533053	154533650	JUNC00006612	107	-	75	75	-304.0	-304.0	-304.0
chrX	154533669	154534034	154533594	154534109	JUNC00006613	159	-	75	75	-304.0	-304.0	-304.0
chrX	154534160	154534337	154534085	154534412	JUNC00006614	189	-	75	75	-304.0	-304.0	-304.0
chrX	154534496	154535167	154534423	154535242	JUNC00006615	173	-	73	75	-304.0	-304.0	-304.0
chrX	154534499	154535167	154534426	154535238	JUNC00006616	24	-	73	71	-304.0	-304.0	-304.0
chrX	154535385	154535936	154535310	154536010	JUNC00006617	163	-	75	74	-304.0	-304.0	-304.0
chrX	154535385	154535953	154535346	154536028	JUNC00006618	10	-	39	75	-304.0	-304.0	-304.0
chrX	154536045	154536140	154535970	154536179	JUNC00006619	172	-	75	39	-304.0	-304.0	-304.0
chrX	154536178	154546035	154536138	154546110	JUNC00006620	154	-	40	75	-304.0	-304.0	-304.0
chrX	154546159	154546788	154546085	154546814	JUNC00006621	2	-	74	26	-304.0	-304.0	-304.0
chrX	154546163	154546788	154546089	154546839	JUNC00006622	46	-	74	51	-304.0	-304.0	-304.0
chrX	154546163	154547467	154546089	154547531	JUNC00006623	16	-	74	64	-304.0	-304.0	-304.0
chrX	154547745	154551987	154547671	154552062	JUNC00006624	86	+	74	75	-304.0	-304.0	-304.0
chrX	154547981	154551987	154547962	154552044	JUNC00006625	1	+	19	57	-304.0	-304.0	-304.0
chrX	154548089	154551987	154548016	154552062	JUNC00006626	7	+	73	75	-304.0	-304.0	-304.0
chrX	154552189	154556164	154552115	154556237	JUNC00006627	91	+	74	73	-304.0	-304.0	-304.0
chrX	154556023	154556135	154555964	154556152	JUNC00006628	1	+	59	17	-304.0	-304.0	-304.0
chrX	154556376	154558531	154556301	154558605	JUNC00006629	95	+	75	74	-304.0	-304.0	-304.0
chrX	154556376	154558534	154556309	154558609	JUNC00006630	12	+	67	75	-304.0	-304.0	-304.0
chrX	154558650	154560406	154558575	154560448	JUNC00006631	14	+	75	42	-304.0	-304.0	-304.0
chrX	154558650	154561687	154558575	154561712	JUNC00006632	2	+	75	25	-304.0	-304.0	-304.0
chrX	154560559	154561687	154560484	154561762	JUNC00006633	30	+	75	75	-304.0	-304.0	-304.0
chrX	154561784	154562809	154561709	154562883	JUNC00006634	91	+	75	74	-304.0	-304.0	-304.0
chrX	154562953	154563558	154562878	154563629	JUNC00006635	127	+	75	71	-304.0	-304.0	-304.0
chrX	154563701	154563874	154563655	154563904	JUNC00006636	1	+	46	30	-304.0	-304.0	-304.0
chrX	154564020	154564318	154563956	154564393	JUNC00006637	20	+	64	75	-304.0	-304.0	-304.0
chrX	154640118	154640416	154640043	154640480	JUNC00006638	39	-	75	64	-304.0	-304.0	-304.0
chrX	154640478	154640735	154640416	154640809	JUNC00006639	114	-	62	74	-304.0	-304.0	-304.0
chrX	154640562	154640735	154640532	154640781	JUNC00006640	1	-	30	46	-304.0	-304.0	-304.0
chrX	154640878	154641484	154640803	154641559	JUNC00006641	150	-	75	75	-304.0	-304.0	-304.0
chrX	154641628	154642653	154641554	154642728	JUNC00006642	91	-	74	75	-304.0	-304.0	-304.0
chrX	154642750	154643878	154642675	154643953	JUNC00006643	30	-	75	75	-304.0	-304.0	-304.0
chrX	154644031	154645787	154643989	154645862	JUNC00006644	14	-	42	75	-304.0	-304.0	-304.0
chrX	154644031	154648061	154644006	154648104	JUNC00006645	1	-	25	43	-304.0	-304.0	-304.0
chrX	154645903	154648061	154645828	154648128	JUNC00006646	12	-	75	67	-304.0	-304.0	-304.0
chrX	154645906	154648061	154645832	154648136	JUNC00006647	90	-	74	75	-304.0	-304.0	-304.0
chrX	154648302	154648414	154648285	154648473	JUNC00006648	1	-	17	59	-304.0	-304.0	-304.0
chrX	154675745	154678174	154675690	154678195	JUNC00006649	1	-	55	21	-304.0	-304.0	-304.0
chrX	154676918	154678174	154676862	154678217	JUNC00006650	2	-	56	43	-304.0	-304.0	-304.0
chrX	154678294	154680131	154678221	154680200	JUNC00006651	3	-	73	69	-304.0	-304.0	-304.0
chrX	154680248	154695916	154680195	154695978	JUNC00006652	3	-	53	62	-304.0	-304.0	-304.0
chrX	154696019	154697131	154695975	154697205	JUNC00006653	8	-	44	74	-304.0	-304.0	-304.0
chrX	154697213	154699293	154697143	154699344	JUNC00006654	5	-	70	51	-304.0	-304.0	-304.0
chrX	154699513	154700003	154699455	154700059	JUNC00006655	5	-	58	56	-304.0	-304.0	-304.0
chrX	154700059	154712228	154700038	154712283	JUNC00006657	1	-	21	55	-304.0	-304.0	-304.0
chrX	154700059	154713206	154700003	154713208	JUNC00006656	1	-	56	2	-304.0	-304.0	-304.0
chrX	154712701	154713206	154712626	154713249	JUNC00006658	4	-	75	43	-304.0	-304.0	-304.0
chrX	154713426	154716025	154713423	154716097	JUNC00006659	1	-	3	72	-304.0	-304.0	-304.0
chrX	154723115	154779954	154723088	154780003	JUNC00006660	1	+	27	49	-304.0	-304.0	-304.0
chrX	154762981	154764898	154762908	154764967	JUNC00006661	121	+	73	69	-304.0	-304.0	-304.0
chrX	154764966	154765443	154764896	154765518	JUNC00006662	225	+	70	75	-304.0	-304.0	-304.0
chrX	154765530	154765906	154765458	154765980	JUNC00006663	184	+	72	74	-304.0	-304.0	-304.0
chrX	154765530	154766264	154765481	154766310	JUNC00006664	2	+	49	46	-304.0	-304.0	-304.0
chrX	154765998	154766215	154765923	154766290	JUNC00006665	208	+	75	75	-304.0	-304.0	-304.0
chrX	154766400	154766996	154766325	154767062	JUNC00006666	285	+	75	66	-304.0	-304.0	-304.0
chrX	154766400	154767255	154766325	154767288	JUNC00006667	5	+	75	33	-304.0	-304.0	-304.0
chrX	154767061	154767255	154766993	154767329	JUNC00006668	163	+	68	74	-304.0	-304.0	-304.0
chrX	154767382	154768301	154767307	154768376	JUNC00006669	241	+	75	75	-304.0	-304.0	-304.0
chrX	154768432	154769166	154768357	154769241	JUNC00006670	277	+	75	75	-304.0	-304.0	-304.0
chrX	154768802	154769166	154768780	154769241	JUNC00006671	12	+	22	75	-304.0	-304.0	-304.0
chrX	154769310	154770758	154769235	154770833	JUNC00006672	301	+	75	75	-304.0	-304.0	-304.0
chrX	154770879	154773130	154770804	154773205	JUNC00006673	258	+	75	75	-304.0	-304.0	-304.0
chrX	154773249	154774601	154773174	154774676	JUNC00006674	244	+	75	75	-304.0	-304.0	-304.0
chrX	154774690	154775194	154774672	154775251	JUNC00006676	1	+	18	57	-304.0	-304.0	-304.0
chrX	154774705	154775194	154774630	154775269	JUNC00006675	208	+	75	75	-304.0	-304.0	-304.0
chrX	154775273	154776186	154775199	154776261	JUNC00006677	263	+	74	75	-304.0	-304.0	-304.0
chrX	154776324	154776798	154776249	154776873	JUNC00006678	271	+	75	75	-304.0	-304.0	-304.0
chrX	154779353	154781238	154779278	154781313	JUNC00006679	34	-	75	75	-304.0	-304.0	-304.0
chrX	154781313	154781599	154781240	154781674	JUNC00006680	61	-	73	75	-304.0	-304.0	-304.0
chrX	154781802	154783426	154781727	154783498	JUNC00006681	40	-	75	72	-304.0	-304.0	-304.0
chrX	154783507	154784027	154783432	154784100	JUNC00006682	53	-	75	73	-304.0	-304.0	-304.0
chrX	154783507	154785050	154783450	154785069	JUNC00006683	1	-	57	19	-304.0	-304.0	-304.0
chrX	154784108	154785050	154784033	154785120	JUNC00006684	40	-	75	70	-304.0	-304.0	-304.0
chrX	154785157	154786203	154785086	154786276	JUNC00006685	51	-	71	73	-304.0	-304.0	-304.0
chrX	154786400	154789953	154786325	154790023	JUNC00006686	42	-	75	70	-304.0	-304.0	-304.0
chrX	154786400	154805271	154786380	154805327	JUNC00006687	1	-	20	56	-304.0	-304.0	-304.0
chrX	154790022	154790982	154789953	154791057	JUNC00006688	34	-	69	75	-304.0	-304.0	-304.0
chrX	154791068	154791768	154790993	154791842	JUNC00006689	45	-	75	74	-304.0	-304.0	-304.0
chrX	154791847	154792141	154791773	154792213	JUNC00006690	42	-	74	72	-304.0	-304.0	-304.0
chrX	154792285	154805271	154792214	154805343	JUNC00006691	32	-	71	72	-304.0	-304.0	-304.0
chrX	154837752	154860431	154837677	154860500	JUNC00006692	19	-	75	69	-304.0	-304.0	-304.0
chrX	154860608	154861717	154860536	154861787	JUNC00006693	14	-	72	70	-304.0	-304.0	-304.0
chrX	154861866	154863082	154861799	154863154	JUNC00006694	19	-	67	72	-304.0	-304.0	-304.0
chrX	154863227	154886133	154863163	154886202	JUNC00006695	14	-	64	69	-304.0	-304.0	-304.0
chrX	154863227	154887095	154863174	154887129	JUNC00006696	2	-	53	34	-304.0	-304.0	-304.0
chrX	154954042	154956956	154954003	154957007	JUNC00006697	2	-	39	51	-304.0	-304.0	-304.0
chrX	154987305	154992935	154987283	154992991	JUNC00006698	2	-	22	56	-304.0	-304.0	-304.0
chrX	155027071	155033402	155027001	155033477	JUNC00006699	181	+	70	75	-304.0	-304.0	-304.0
chrX	155027430	155033402	155027362	155033468	JUNC00006700	3	+	68	66	-304.0	-304.0	-304.0
chrX	155033553	155046508	155033478	155046582	JUNC00006701	343	+	75	74	-304.0	-304.0	-304.0
chrX	155033553	155051669	155033510	155051744	JUNC00006702	5	+	43	75	-304.0	-304.0	-304.0
chrX	155046584	155051669	155046510	155051744	JUNC00006703	427	+	74	75	-304.0	-304.0	-304.0
chrX	155051780	155054594	155051705	155054669	JUNC00006704	7	+	75	75	-304.0	-304.0	-304.0
chrX	155051801	155054594	155051726	155054669	JUNC00006705	319	+	75	75	-304.0	-304.0	-304.0
chrX	155051801	155063991	155051726	155064027	JUNC00006706	3	+	75	36	-304.0	-304.0	-304.0
chrX	155061991	155063965	155061916	155064033	JUNC00006707	155	-	75	68	-304.0	-304.0	-304.0
chrX	155064014	155070963	155063973	155070998	JUNC00006710	1	-	41	35	-304.0	-304.0	-304.0
chrX	155064033	155064936	155064007	155064986	JUNC00006712	1	-	26	50	-304.0	-304.0	-304.0
chrX	155064033	155070693	155063965	155070768	JUNC00006708	72	-	68	75	-304.0	-304.0	-304.0
chrX	155064033	155070948	155063992	155070983	JUNC00006711	1	-	41	35	-304.0	-304.0	-304.0
chrX	155064033	155070963	155063965	155071036	JUNC00006709	43	-	68	73	-304.0	-304.0	-304.0
chrX	155065399	155065485	155065350	155065512	JUNC00006713	1	-	49	27	-304.0	-304.0	-304.0
chrX	155065537	155065618	155065519	155065677	JUNC00006714	2	-	18	59	-304.0	-304.0	-304.0
chrX	155065789	155070693	155065735	155070715	JUNC00006715	1	-	54	22	-304.0	-304.0	-304.0
chrX	155070437	155070693	155070396	155070728	JUNC00006716	1	-	41	35	-304.0	-304.0	-304.0
chrX	155071650	155072326	155071575	155072345	JUNC00006717	74	+	75	19	-304.0	-304.0	-304.0
chrX	155071650	155073376	155071599	155073431	JUNC00006719	4	+	51	55	-304.0	-304.0	-304.0
chrX	155072343	155073373	155072326	155073427	JUNC00006720	7	+	17	54	-304.0	-304.0	-304.0
chrX	155072343	155073376	155072324	155073433	JUNC00006718	63	+	19	57	-304.0	-304.0	-304.0
chrX	155072343	155077169	155072326	155077205	JUNC00006721	1	+	17	36	-304.0	-304.0	-304.0
chrX	155073431	155077169	155073374	155077242	JUNC00006722	68	+	57	73	-304.0	-304.0	-304.0
chrX	155078703	155089262	155078629	155089336	JUNC00006723	58	+	74	74	-304.0	-304.0	-304.0
chrX	155089351	155090783	155089276	155090840	JUNC00006724	89	+	75	57	-304.0	-304.0	-304.0
chrX	155090839	155094810	155090781	155094828	JUNC00006727	3	+	58	18	-304.0	-304.0	-304.0
chrX	155090839	155099314	155090783	155099386	JUNC00006726	22	+	56	72	-304.0	-304.0	-304.0
chrX	155090839	155116056	155090783	155116129	JUNC00006725	87	+	56	73	-304.0	-304.0	-304.0
chrX	155099389	155116056	155099320	155116130	JUNC00006728	16	+	69	74	-304.0	-304.0	-304.0
chrX	155116188	155116710	155116117	155116754	JUNC00006729	77	+	71	44	-304.0	-304.0	-304.0
chrX	155116754	155119998	155116710	155120073	JUNC00006730	63	+	44	75	-304.0	-304.0	-304.0
chrX	155120168	155121222	155120093	155121297	JUNC00006731	63	+	75	75	-304.0	-304.0	-304.0
chrX	155175745	155208873	155175695	155208899	JUNC00006732	1	+	50	26	-304.0	-304.0	-304.0
chrX	155216575	155220162	155216557	155220220	JUNC00006735	1	+	18	58	-304.0	-304.0	-304.0
chrX	155216575	155220182	155216501	155220257	JUNC00006733	197	+	74	75	-304.0	-304.0	-304.0
chrX	155216575	155220186	155216525	155220212	JUNC00006734	2	+	50	26	-304.0	-304.0	-304.0
chrX	155220307	155227234	155220233	155227308	JUNC00006736	234	+	74	74	-304.0	-304.0	-304.0
chrX	155225517	155227234	155225471	155227301	JUNC00006738	7	+	46	67	-304.0	-304.0	-304.0
chrX	155227301	155228383	155227233	155228458	JUNC00006737	288	+	68	75	-304.0	-304.0	-304.0
chrX	155228482	155236228	155228408	155236303	JUNC00006739	216	+	74	75	-304.0	-304.0	-304.0
chrX	155236367	155238771	155236292	155238845	JUNC00006740	278	+	75	74	-304.0	-304.0	-304.0
chrX	155261229	155264073	155261154	155264147	JUNC00006741	36	-	75	74	-304.0	-304.0	-304.0
chrX	155278064	155278810	155278029	155278851	JUNC00006743	1	-	35	41	-304.0	-304.0	-304.0
chrX	155278064	155279148	155277994	155279222	JUNC00006742	24	-	70	74	-304.0	-304.0	-304.0
chrX	155279330	155279961	155279258	155280035	JUNC00006744	24	-	72	74	-304.0	-304.0	-304.0
chrX	155280068	155298784	155279995	155298857	JUNC00006745	21	-	73	73	-304.0	-304.0	-304.0
chrX	155298910	155299035	155298835	155299110	JUNC00006746	16	-	75	75	-304.0	-304.0	-304.0
chrX	155299145	155334370	155299083	155334444	JUNC00006747	11	-	62	74	-304.0	-304.0	-304.0
chrX	155348890	155349581	155348815	155349649	JUNC00006748	19	+	75	68	-304.0	-304.0	-304.0
chrX	155349853	155352325	155349804	155352352	JUNC00006749	1	+	49	27	-304.0	-304.0	-304.0
chrX	155354666	155372341	155354633	155372384	JUNC00006750	1	-	33	43	-304.0	-304.0	-304.0
chrX	155372430	155381873	155372372	155381891	JUNC00006751	1	-	58	18	-304.0	-304.0	-304.0
chrX	155458841	155468285	155458823	155468343	JUNC00006752	1	+	18	58	-304.0	-304.0	-304.0
chrX	155468374	155486582	155468331	155486615	JUNC00006753	1	+	43	33	-304.0	-304.0	-304.0
chrX	155488923	155491394	155488896	155491443	JUNC00006754	1	-	27	49	-304.0	-304.0	-304.0
chrX	155491666	155492356	155491598	155492431	JUNC00006755	28	-	68	75	-304.0	-304.0	-304.0
chrX	155492495	155506897	155492424	155506969	JUNC00006756	46	-	71	72	-304.0	-304.0	-304.0
chrX	155492700	155506897	155492653	155506926	JUNC00006757	1	-	47	29	-304.0	-304.0	-304.0
chrX	155507134	155511672	155507059	155511747	JUNC00006758	47	-	75	75	-304.0	-304.0	-304.0
chrX	155511792	155513985	155511718	155514059	JUNC00006759	55	-	74	74	-304.0	-304.0	-304.0
chrX	155514265	155524455	155514190	155524528	JUNC00006760	59	-	75	73	-304.0	-304.0	-304.0
chrX	155524632	155545095	155524558	155545169	JUNC00006761	54	-	74	74	-304.0	-304.0	-304.0
chrX	155537118	155545095	155537070	155545123	JUNC00006763	1	-	48	28	-304.0	-304.0	-304.0
chrX	155537118	155612791	155537067	155612816	JUNC00006762	1	-	51	25	-304.0	-304.0	-304.0
chrX	155545277	155612791	155545202	155612866	JUNC00006764	50	-	75	75	-304.0	-304.0	-304.0
chrX	155672999	155678981	155672981	155679037	JUNC00006765	1	+	18	56	-304.0	-304.0	-304.0
chrX	155737347	155739542	155737313	155739584	JUNC00006766	1	-	34	42	-304.0	-304.0	-304.0
chrX	155769862	155773765	155769833	155773812	JUNC00006767	1	+	29	47	-304.0	-304.0	-304.0
chrX	155881448	155889457	155881381	155889530	JUNC00006768	51	+	67	73	-304.0	-304.0	-304.0
chrX	155881448	155898111	155881424	155898163	JUNC00006769	1	+	24	52	-304.0	-304.0	-304.0
chrX	155889547	155895622	155889490	155895680	JUNC00006770	4	+	57	58	-304.0	-304.0	-304.0
chrX	155889612	155895622	155889537	155895680	JUNC00006771	122	+	75	58	-304.0	-304.0	-304.0
chrX	155889612	155898111	155889550	155898168	JUNC00006773	2	+	62	57	-304.0	-304.0	-304.0
chrX	155889633	155895622	155889580	155895677	JUNC00006774	3	+	53	55	-304.0	-304.0	-304.0
chrX	155895680	155898111	155895621	155898186	JUNC00006772	115	+	59	75	-304.0	-304.0	-304.0
chrX	155898249	155900496	155898174	155900570	JUNC00006775	148	+	75	74	-304.0	-304.0	-304.0
chrX	155898249	155900499	155898185	155900539	JUNC00006776	2	+	64	40	-304.0	-304.0	-304.0
chrX	155898249	155939700	155898213	155939740	JUNC00006777	1	+	36	40	-304.0	-304.0	-304.0
chrX	155900587	155919812	155900512	155919880	JUNC00006778	159	+	75	68	-304.0	-304.0	-304.0
chrX	155900587	155939700	155900532	155939764	JUNC00006779	6	+	55	64	-304.0	-304.0	-304.0
chrX	155919880	155939700	155919811	155939775	JUNC00006780	131	+	69	75	-304.0	-304.0	-304.0
chrX	155939793	155941882	155939718	155941956	JUNC00006781	118	+	75	74	-304.0	-304.0	-304.0
chrX	155997787	156001329	155997713	156001397	JUNC00006782	4	+	74	68	-304.0	-304.0	-304.0
chrX	155997787	156001407	155997742	156001477	JUNC00006785	8	+	45	70	-304.0	-304.0	-304.0
chrX	155997787	156002905	155997713	156002976	JUNC00006783	4	+	74	71	-304.0	-304.0	-304.0
chrX	155997787	156003676	155997768	156003733	JUNC00006787	1	+	19	57	-304.0	-304.0	-304.0
chrX	155997787	156004419	155997758	156004473	JUNC00006786	2	+	29	54	-304.0	-304.0	-304.0
chrX	155997787	156004448	155997739	156004505	JUNC00006784	2	+	48	57	-304.0	-304.0	-304.0
chrX	155998302	155998594	155998258	155998626	JUNC00006788	1	+	44	32	-304.0	-304.0	-304.0
chrX	155998714	156001407	155998658	156001427	JUNC00006789	1	+	56	20	-304.0	-304.0	-304.0
chrX	156001508	156002881	156001472	156002953	JUNC00006791	2	+	36	72	-304.0	-304.0	-304.0
chrX	156001508	156002905	156001445	156002957	JUNC00006790	5	+	63	52	-304.0	-304.0	-304.0
chrX	156001508	156003279	156001491	156003338	JUNC00006792	1	+	17	59	-304.0	-304.0	-304.0
chrX	156003019	156003255	156002956	156003288	JUNC00006794	2	+	63	33	-304.0	-304.0	-304.0
chrX	156003019	156003360	156002969	156003386	JUNC00006795	1	+	50	26	-304.0	-304.0	-304.0
chrX	156003019	156003448	156002952	156003501	JUNC00006793	4	+	67	53	-304.0	-304.0	-304.0
chrX	156003560	156003676	156003495	156003749	JUNC00006796	11	+	65	73	-304.0	-304.0	-304.0
chrX	156003855	156004419	156003783	156004487	JUNC00006797	10	+	72	68	-304.0	-304.0	-304.0
chrX	156004565	156005277	156004496	156005341	JUNC00006798	17	+	69	64	-304.0	-304.0	-304.0
chrX	156005479	156006082	156005405	156006154	JUNC00006799	17	+	74	72	-304.0	-304.0	-304.0
chrX	156006188	156007522	156006118	156007590	JUNC00006800	11	+	70	68	-304.0	-304.0	-304.0
chrX	156007607	156007898	156007557	156007924	JUNC00006801	1	+	50	26	-304.0	-304.0	-304.0
chrX	156007607	156009815	156007578	156009865	JUNC00006802	3	+	29	50	-304.0	-304.0	-304.0
chrX	156008910	156009241	156008885	156009292	JUNC00006803	1	?	25	51	120.0	110.0	120.0
chrX	156009045	156009304	156009003	156009338	JUNC00006804	1	?	42	34	-304.0	-304.0	-304.0
chrX	156009117	156009195	156009087	156009241	JUNC00006805	1	?	30	46	-304.0	-304.0	-304.0
chrX	156021148	156021680	156021073	156021755	JUNC00006807	11	+	75	75	-304.0	-304.0	-304.0
chrX	156021148	156021693	156021073	156021764	JUNC00006806	12	+	75	71	-304.0	-304.0	-304.0
chrX	156021792	156021998	156021718	156022073	JUNC00006808	53	+	74	75	-304.0	-304.0	-304.0
chrX	156022145	156022322	156022107	156022379	JUNC00006809	2	+	38	57	-304.0	-304.0	-304.0
chrX	156022459	156023011	156022442	156023067	JUNC00006810	1	+	17	56	-304.0	-304.0	-304.0
chrX	156022834	156023011	156022766	156023086	JUNC00006811	9	+	68	75	-304.0	-304.0	-304.0
chrX	156023213	156023301	156023160	156023324	JUNC00006812	2	+	53	23	-304.0	-304.0	-304.0
chrX	156023460	156024119	156023411	156024194	JUNC00006813	11	+	49	75	-304.0	-304.0	-304.0
chrX	156024272	156025031	156024197	156025104	JUNC00006814	174	+	75	73	-304.0	-304.0	-304.0
chrX	156024759	156025031	156024724	156025101	JUNC00006817	3	+	35	70	-304.0	-304.0	-304.0
chrX	156025049	156025240	156025031	156025288	JUNC00006815	1	+	18	48	-304.0	-304.0	-304.0
chrX	156025100	156025240	156025029	156025313	JUNC00006816	200	+	71	73	-304.0	-304.0	-304.0
chrX	156027444	156027829	156027412	156027873	JUNC00006818	1	-	32	44	-304.0	-304.0	-304.0
